Museums in Algiers|select c.city_name, m.museum_name, m.type, m.description from city c join museum m on c.city_id = m.city_id where c.city_name = 'algiers'
Parks in Algiers|select c.city_name, p.park_name, p.type, p.description from city c join park p on c.city_id = p.city_id where c.city_name = 'algiers'
Famous Sightseeing in Algiers|select c.city_name, s.sight_name, s.description from city c join famous_sight s on c.city_id = s.city_id where c.city_name = 'algiers'
Restaurants in Algiers|select c.city_name, r.rest_name, r.description, r.avg_price_usd from city c join restaurant r on c.city_id = r.city_id where c.city_name = 'algiers'
Dishes in Algiers|select f.dish_name, f.description, f.price_usd, r.rest_name, c.city_name from (city c join restaurant r on c.city_id = r.city_id) join food f on f.restaurant_id = r.rest_id where c.city_name = 'algiers'
Museums in Algeria|select c.city_name, c.country, m.museum_name, m.type, m.description from city c join museum m on c.city_id = m.city_id where c.country = 'algeria'
Parks in Algeria|select c.city_name, c.country, p.park_name, p.type, p.description from city c join park p on c.city_id = p.city_id where c.country = 'algeria'
Famous Sightseeing in Algeria|select c.city_name, c.country, s.sight_name, s.description from city c join famous_sight s on c.city_id = s.city_id where c.country = 'algeria'
Restaurants in Algeria|select c.city_name, c.country, r.rest_name, r.description, r.avg_price_usd from city c join restaurant r on c.city_id = r.city_id where c.country = 'algeria'
Dishes in Algeria|select f.dish_name, f.description, f.price_usd, r.rest_name, c.city_name, c.country from (city c join restaurant r on c.city_id = r.city_id) join food f on f.restaurant_id = r.rest_id where c.country = 'algeria'
Museums in Africa|select c.city_name, c.country, c.continent, m.museum_name, m.type, m.description from city c join museum m on c.city_id = m.city_id where c.continent = 'africa'
Parks in Africa|select c.city_name, c.country, c.continent, p.park_name, p.type, p.description from city c join park p on c.city_id = p.city_id where c.continent = 'africa'
Famous Sightseeing in Africa|select c.city_name, c.country, c.continent, s.sight_name, s.description from city c join famous_sight s on c.city_id = s.city_id where c.continent = 'africa'
Restaurants in Africa|select c.city_name, c.country, c.continent, r.rest_name, r.description, r.avg_price_usd from city c join restaurant r on c.city_id = r.city_id where c.continent = 'africa'
Dishes in Africa|select f.dish_name, f.description, f.price_usd, r.rest_name, c.city_name, c.country, c.continent from (city c join restaurant r on c.city_id = r.city_id) join food f on f.restaurant_id = r.rest_id where c.continent = 'africa'
Museums in Luanda|select c.city_name, m.museum_name, m.type, m.description from city c join museum m on c.city_id = m.city_id where c.city_name = 'luanda'
Parks in Luanda|select c.city_name, p.park_name, p.type, p.description from city c join park p on c.city_id = p.city_id where c.city_name = 'luanda'
Famous Sightseeing in Luanda|select c.city_name, s.sight_name, s.description from city c join famous_sight s on c.city_id = s.city_id where c.city_name = 'luanda'
Restaurants in Luanda|select c.city_name, r.rest_name, r.description, r.avg_price_usd from city c join restaurant r on c.city_id = r.city_id where c.city_name = 'luanda'
Dishes in Luanda|select f.dish_name, f.description, f.price_usd, r.rest_name, c.city_name from (city c join restaurant r on c.city_id = r.city_id) join food f on f.restaurant_id = r.rest_id where c.city_name = 'luanda'
Museums in Angola|select c.city_name, c.country, m.museum_name, m.type, m.description from city c join museum m on c.city_id = m.city_id where c.country = 'angola'
Parks in Angola|select c.city_name, c.country, p.park_name, p.type, p.description from city c join park p on c.city_id = p.city_id where c.country = 'angola'
Famous Sightseeing in Angola|select c.city_name, c.country, s.sight_name, s.description from city c join famous_sight s on c.city_id = s.city_id where c.country = 'angola'
Restaurants in Angola|select c.city_name, c.country, r.rest_name, r.description, r.avg_price_usd from city c join restaurant r on c.city_id = r.city_id where c.country = 'angola'
Dishes in Angola|select f.dish_name, f.description, f.price_usd, r.rest_name, c.city_name, c.country from (city c join restaurant r on c.city_id = r.city_id) join food f on f.restaurant_id = r.rest_id where c.country = 'angola'
Museums in Sydney|select c.city_name, m.museum_name, m.type, m.description from city c join museum m on c.city_id = m.city_id where c.city_name = 'sydney'
Parks in Sydney|select c.city_name, p.park_name, p.type, p.description from city c join park p on c.city_id = p.city_id where c.city_name = 'sydney'
Famous Sightseeing in Sydney|select c.city_name, s.sight_name, s.description from city c join famous_sight s on c.city_id = s.city_id where c.city_name = 'sydney'
Restaurants in Sydney|select c.city_name, r.rest_name, r.description, r.avg_price_usd from city c join restaurant r on c.city_id = r.city_id where c.city_name = 'sydney'
Dishes in Sydney|select f.dish_name, f.description, f.price_usd, r.rest_name, c.city_name from (city c join restaurant r on c.city_id = r.city_id) join food f on f.restaurant_id = r.rest_id where c.city_name = 'sydney'
Museums in Australia|select c.city_name, c.country, m.museum_name, m.type, m.description from city c join museum m on c.city_id = m.city_id where c.country = 'australia'
Parks in Australia|select c.city_name, c.country, p.park_name, p.type, p.description from city c join park p on c.city_id = p.city_id where c.country = 'australia'
Famous Sightseeing in Australia|select c.city_name, c.country, s.sight_name, s.description from city c join famous_sight s on c.city_id = s.city_id where c.country = 'australia'
Restaurants in Australia|select c.city_name, c.country, r.rest_name, r.description, r.avg_price_usd from city c join restaurant r on c.city_id = r.city_id where c.country = 'australia'
Dishes in Australia|select f.dish_name, f.description, f.price_usd, r.rest_name, c.city_name, c.country from (city c join restaurant r on c.city_id = r.city_id) join food f on f.restaurant_id = r.rest_id where c.country = 'australia'
Museums in Oceania|select c.city_name, c.country, c.continent, m.museum_name, m.type, m.description from city c join museum m on c.city_id = m.city_id where c.continent = 'oceania'
Parks in Oceania|select c.city_name, c.country, c.continent, p.park_name, p.type, p.description from city c join park p on c.city_id = p.city_id where c.continent = 'oceania'
Famous Sightseeing in Oceania|select c.city_name, c.country, c.continent, s.sight_name, s.description from city c join famous_sight s on c.city_id = s.city_id where c.continent = 'oceania'
Restaurants in Oceania|select c.city_name, c.country, c.continent, r.rest_name, r.description, r.avg_price_usd from city c join restaurant r on c.city_id = r.city_id where c.continent = 'oceania'
Dishes in Oceania|select f.dish_name, f.description, f.price_usd, r.rest_name, c.city_name, c.country, c.continent from (city c join restaurant r on c.city_id = r.city_id) join food f on f.restaurant_id = r.rest_id where c.continent = 'oceania'
Museums in Brisbane|select c.city_name, m.museum_name, m.type, m.description from city c join museum m on c.city_id = m.city_id where c.city_name = 'brisbane'
Parks in Brisbane|select c.city_name, p.park_name, p.type, p.description from city c join park p on c.city_id = p.city_id where c.city_name = 'brisbane'
Famous Sightseeing in Brisbane|select c.city_name, s.sight_name, s.description from city c join famous_sight s on c.city_id = s.city_id where c.city_name = 'brisbane'
Restaurants in Brisbane|select c.city_name, r.rest_name, r.description, r.avg_price_usd from city c join restaurant r on c.city_id = r.city_id where c.city_name = 'brisbane'
Dishes in Brisbane|select f.dish_name, f.description, f.price_usd, r.rest_name, c.city_name from (city c join restaurant r on c.city_id = r.city_id) join food f on f.restaurant_id = r.rest_id where c.city_name = 'brisbane'
Museums in Vienna|select c.city_name, m.museum_name, m.type, m.description from city c join museum m on c.city_id = m.city_id where c.city_name = 'vienna'
Parks in Vienna|select c.city_name, p.park_name, p.type, p.description from city c join park p on c.city_id = p.city_id where c.city_name = 'vienna'
Famous Sightseeing in Vienna|select c.city_name, s.sight_name, s.description from city c join famous_sight s on c.city_id = s.city_id where c.city_name = 'vienna'
Restaurants in Vienna|select c.city_name, r.rest_name, r.description, r.avg_price_usd from city c join restaurant r on c.city_id = r.city_id where c.city_name = 'vienna'
Dishes in Vienna|select f.dish_name, f.description, f.price_usd, r.rest_name, c.city_name from (city c join restaurant r on c.city_id = r.city_id) join food f on f.restaurant_id = r.rest_id where c.city_name = 'vienna'
Museums in Austria|select c.city_name, c.country, m.museum_name, m.type, m.description from city c join museum m on c.city_id = m.city_id where c.country = 'austria'
Parks in Austria|select c.city_name, c.country, p.park_name, p.type, p.description from city c join park p on c.city_id = p.city_id where c.country = 'austria'
Famous Sightseeing in Austria|select c.city_name, c.country, s.sight_name, s.description from city c join famous_sight s on c.city_id = s.city_id where c.country = 'austria'
Restaurants in Austria|select c.city_name, c.country, r.rest_name, r.description, r.avg_price_usd from city c join restaurant r on c.city_id = r.city_id where c.country = 'austria'
Dishes in Austria|select f.dish_name, f.description, f.price_usd, r.rest_name, c.city_name, c.country from (city c join restaurant r on c.city_id = r.city_id) join food f on f.restaurant_id = r.rest_id where c.country = 'austria'
Museums in Europe|select c.city_name, c.country, c.continent, m.museum_name, m.type, m.description from city c join museum m on c.city_id = m.city_id where c.continent = 'europe'
Parks in Europe|select c.city_name, c.country, c.continent, p.park_name, p.type, p.description from city c join park p on c.city_id = p.city_id where c.continent = 'europe'
Famous Sightseeing in Europe|select c.city_name, c.country, c.continent, s.sight_name, s.description from city c join famous_sight s on c.city_id = s.city_id where c.continent = 'europe'
Restaurants in Europe|select c.city_name, c.country, c.continent, r.rest_name, r.description, r.avg_price_usd from city c join restaurant r on c.city_id = r.city_id where c.continent = 'europe'
Dishes in Europe|select f.dish_name, f.description, f.price_usd, r.rest_name, c.city_name, c.country, c.continent from (city c join restaurant r on c.city_id = r.city_id) join food f on f.restaurant_id = r.rest_id where c.continent = 'europe'
Museums in Baku|select c.city_name, m.museum_name, m.type, m.description from city c join museum m on c.city_id = m.city_id where c.city_name = 'baku'
Parks in Baku|select c.city_name, p.park_name, p.type, p.description from city c join park p on c.city_id = p.city_id where c.city_name = 'baku'
Famous Sightseeing in Baku|select c.city_name, s.sight_name, s.description from city c join famous_sight s on c.city_id = s.city_id where c.city_name = 'baku'
Restaurants in Baku|select c.city_name, r.rest_name, r.description, r.avg_price_usd from city c join restaurant r on c.city_id = r.city_id where c.city_name = 'baku'
Dishes in Baku|select f.dish_name, f.description, f.price_usd, r.rest_name, c.city_name from (city c join restaurant r on c.city_id = r.city_id) join food f on f.restaurant_id = r.rest_id where c.city_name = 'baku'
Museums in Azerbaijan|select c.city_name, c.country, m.museum_name, m.type, m.description from city c join museum m on c.city_id = m.city_id where c.country = 'azerbaijan'
Parks in Azerbaijan|select c.city_name, c.country, p.park_name, p.type, p.description from city c join park p on c.city_id = p.city_id where c.country = 'azerbaijan'
Famous Sightseeing in Azerbaijan|select c.city_name, c.country, s.sight_name, s.description from city c join famous_sight s on c.city_id = s.city_id where c.country = 'azerbaijan'
Restaurants in Azerbaijan|select c.city_name, c.country, r.rest_name, r.description, r.avg_price_usd from city c join restaurant r on c.city_id = r.city_id where c.country = 'azerbaijan'
Dishes in Azerbaijan|select f.dish_name, f.description, f.price_usd, r.rest_name, c.city_name, c.country from (city c join restaurant r on c.city_id = r.city_id) join food f on f.restaurant_id = r.rest_id where c.country = 'azerbaijan'
Museums in Asia|select c.city_name, c.country, c.continent, m.museum_name, m.type, m.description from city c join museum m on c.city_id = m.city_id where c.continent = 'asia'
Parks in Asia|select c.city_name, c.country, c.continent, p.park_name, p.type, p.description from city c join park p on c.city_id = p.city_id where c.continent = 'asia'
Famous Sightseeing in Asia|select c.city_name, c.country, c.continent, s.sight_name, s.description from city c join famous_sight s on c.city_id = s.city_id where c.continent = 'asia'
Restaurants in Asia|select c.city_name, c.country, c.continent, r.rest_name, r.description, r.avg_price_usd from city c join restaurant r on c.city_id = r.city_id where c.continent = 'asia'
Dishes in Asia|select f.dish_name, f.description, f.price_usd, r.rest_name, c.city_name, c.country, c.continent from (city c join restaurant r on c.city_id = r.city_id) join food f on f.restaurant_id = r.rest_id where c.continent = 'asia'
Museums in Dhaka|select c.city_name, m.museum_name, m.type, m.description from city c join museum m on c.city_id = m.city_id where c.city_name = 'dhaka'
Parks in Dhaka|select c.city_name, p.park_name, p.type, p.description from city c join park p on c.city_id = p.city_id where c.city_name = 'dhaka'
Famous Sightseeing in Dhaka|select c.city_name, s.sight_name, s.description from city c join famous_sight s on c.city_id = s.city_id where c.city_name = 'dhaka'
Restaurants in Dhaka|select c.city_name, r.rest_name, r.description, r.avg_price_usd from city c join restaurant r on c.city_id = r.city_id where c.city_name = 'dhaka'
Dishes in Dhaka|select f.dish_name, f.description, f.price_usd, r.rest_name, c.city_name from (city c join restaurant r on c.city_id = r.city_id) join food f on f.restaurant_id = r.rest_id where c.city_name = 'dhaka'
Museums in Bangladesh|select c.city_name, c.country, m.museum_name, m.type, m.description from city c join museum m on c.city_id = m.city_id where c.country = 'bangladesh'
Parks in Bangladesh|select c.city_name, c.country, p.park_name, p.type, p.description from city c join park p on c.city_id = p.city_id where c.country = 'bangladesh'
Famous Sightseeing in Bangladesh|select c.city_name, c.country, s.sight_name, s.description from city c join famous_sight s on c.city_id = s.city_id where c.country = 'bangladesh'
Restaurants in Bangladesh|select c.city_name, c.country, r.rest_name, r.description, r.avg_price_usd from city c join restaurant r on c.city_id = r.city_id where c.country = 'bangladesh'
Dishes in Bangladesh|select f.dish_name, f.description, f.price_usd, r.rest_name, c.city_name, c.country from (city c join restaurant r on c.city_id = r.city_id) join food f on f.restaurant_id = r.rest_id where c.country = 'bangladesh'
Museums in Rio De Janeiro|select c.city_name, m.museum_name, m.type, m.description from city c join museum m on c.city_id = m.city_id where c.city_name = 'rio de janeiro'
Parks in Rio De Janeiro|select c.city_name, p.park_name, p.type, p.description from city c join park p on c.city_id = p.city_id where c.city_name = 'rio de janeiro'
Famous Sightseeing in Rio De Janeiro|select c.city_name, s.sight_name, s.description from city c join famous_sight s on c.city_id = s.city_id where c.city_name = 'rio de janeiro'
Restaurants in Rio De Janeiro|select c.city_name, r.rest_name, r.description, r.avg_price_usd from city c join restaurant r on c.city_id = r.city_id where c.city_name = 'rio de janeiro'
Dishes in Rio De Janeiro|select f.dish_name, f.description, f.price_usd, r.rest_name, c.city_name from (city c join restaurant r on c.city_id = r.city_id) join food f on f.restaurant_id = r.rest_id where c.city_name = 'rio de janeiro'
Museums in Brazil|select c.city_name, c.country, m.museum_name, m.type, m.description from city c join museum m on c.city_id = m.city_id where c.country = 'brazil'
Parks in Brazil|select c.city_name, c.country, p.park_name, p.type, p.description from city c join park p on c.city_id = p.city_id where c.country = 'brazil'
Famous Sightseeing in Brazil|select c.city_name, c.country, s.sight_name, s.description from city c join famous_sight s on c.city_id = s.city_id where c.country = 'brazil'
Restaurants in Brazil|select c.city_name, c.country, r.rest_name, r.description, r.avg_price_usd from city c join restaurant r on c.city_id = r.city_id where c.country = 'brazil'
Dishes in Brazil|select f.dish_name, f.description, f.price_usd, r.rest_name, c.city_name, c.country from (city c join restaurant r on c.city_id = r.city_id) join food f on f.restaurant_id = r.rest_id where c.country = 'brazil'
Museums in South America|select c.city_name, c.country, c.continent, m.museum_name, m.type, m.description from city c join museum m on c.city_id = m.city_id where c.continent = 'south america'
Parks in South America|select c.city_name, c.country, c.continent, p.park_name, p.type, p.description from city c join park p on c.city_id = p.city_id where c.continent = 'south america'
Famous Sightseeing in South America|select c.city_name, c.country, c.continent, s.sight_name, s.description from city c join famous_sight s on c.city_id = s.city_id where c.continent = 'south america'
Restaurants in South America|select c.city_name, c.country, c.continent, r.rest_name, r.description, r.avg_price_usd from city c join restaurant r on c.city_id = r.city_id where c.continent = 'south america'
Dishes in South America|select f.dish_name, f.description, f.price_usd, r.rest_name, c.city_name, c.country, c.continent from (city c join restaurant r on c.city_id = r.city_id) join food f on f.restaurant_id = r.rest_id where c.continent = 'south america'
Museums in Sao Paulo|select c.city_name, m.museum_name, m.type, m.description from city c join museum m on c.city_id = m.city_id where c.city_name = 'sao paulo'
Parks in Sao Paulo|select c.city_name, p.park_name, p.type, p.description from city c join park p on c.city_id = p.city_id where c.city_name = 'sao paulo'
Famous Sightseeing in Sao Paulo|select c.city_name, s.sight_name, s.description from city c join famous_sight s on c.city_id = s.city_id where c.city_name = 'sao paulo'
Restaurants in Sao Paulo|select c.city_name, r.rest_name, r.description, r.avg_price_usd from city c join restaurant r on c.city_id = r.city_id where c.city_name = 'sao paulo'
Dishes in Sao Paulo|select f.dish_name, f.description, f.price_usd, r.rest_name, c.city_name from (city c join restaurant r on c.city_id = r.city_id) join food f on f.restaurant_id = r.rest_id where c.city_name = 'sao paulo'
Museums in Belo Horizonte|select c.city_name, m.museum_name, m.type, m.description from city c join museum m on c.city_id = m.city_id where c.city_name = 'belo horizonte'
Parks in Belo Horizonte|select c.city_name, p.park_name, p.type, p.description from city c join park p on c.city_id = p.city_id where c.city_name = 'belo horizonte'
Famous Sightseeing in Belo Horizonte|select c.city_name, s.sight_name, s.description from city c join famous_sight s on c.city_id = s.city_id where c.city_name = 'belo horizonte'
Restaurants in Belo Horizonte|select c.city_name, r.rest_name, r.description, r.avg_price_usd from city c join restaurant r on c.city_id = r.city_id where c.city_name = 'belo horizonte'
Dishes in Belo Horizonte|select f.dish_name, f.description, f.price_usd, r.rest_name, c.city_name from (city c join restaurant r on c.city_id = r.city_id) join food f on f.restaurant_id = r.rest_id where c.city_name = 'belo horizonte'
Museums in Brasilia|select c.city_name, m.museum_name, m.type, m.description from city c join museum m on c.city_id = m.city_id where c.city_name = 'brasilia'
Parks in Brasilia|select c.city_name, p.park_name, p.type, p.description from city c join park p on c.city_id = p.city_id where c.city_name = 'brasilia'
Famous Sightseeing in Brasilia|select c.city_name, s.sight_name, s.description from city c join famous_sight s on c.city_id = s.city_id where c.city_name = 'brasilia'
Restaurants in Brasilia|select c.city_name, r.rest_name, r.description, r.avg_price_usd from city c join restaurant r on c.city_id = r.city_id where c.city_name = 'brasilia'
Dishes in Brasilia|select f.dish_name, f.description, f.price_usd, r.rest_name, c.city_name from (city c join restaurant r on c.city_id = r.city_id) join food f on f.restaurant_id = r.rest_id where c.city_name = 'brasilia'
Museums in Manaus|select c.city_name, m.museum_name, m.type, m.description from city c join museum m on c.city_id = m.city_id where c.city_name = 'manaus'
Parks in Manaus|select c.city_name, p.park_name, p.type, p.description from city c join park p on c.city_id = p.city_id where c.city_name = 'manaus'
Famous Sightseeing in Manaus|select c.city_name, s.sight_name, s.description from city c join famous_sight s on c.city_id = s.city_id where c.city_name = 'manaus'
Restaurants in Manaus|select c.city_name, r.rest_name, r.description, r.avg_price_usd from city c join restaurant r on c.city_id = r.city_id where c.city_name = 'manaus'
Dishes in Manaus|select f.dish_name, f.description, f.price_usd, r.rest_name, c.city_name from (city c join restaurant r on c.city_id = r.city_id) join food f on f.restaurant_id = r.rest_id where c.city_name = 'manaus'
Museums in Recife|select c.city_name, m.museum_name, m.type, m.description from city c join museum m on c.city_id = m.city_id where c.city_name = 'recife'
Parks in Recife|select c.city_name, p.park_name, p.type, p.description from city c join park p on c.city_id = p.city_id where c.city_name = 'recife'
Famous Sightseeing in Recife|select c.city_name, s.sight_name, s.description from city c join famous_sight s on c.city_id = s.city_id where c.city_name = 'recife'
Restaurants in Recife|select c.city_name, r.rest_name, r.description, r.avg_price_usd from city c join restaurant r on c.city_id = r.city_id where c.city_name = 'recife'
Dishes in Recife|select f.dish_name, f.description, f.price_usd, r.rest_name, c.city_name from (city c join restaurant r on c.city_id = r.city_id) join food f on f.restaurant_id = r.rest_id where c.city_name = 'recife'
Museums in Porto Alegre|select c.city_name, m.museum_name, m.type, m.description from city c join museum m on c.city_id = m.city_id where c.city_name = 'porto alegre'
Parks in Porto Alegre|select c.city_name, p.park_name, p.type, p.description from city c join park p on c.city_id = p.city_id where c.city_name = 'porto alegre'
Famous Sightseeing in Porto Alegre|select c.city_name, s.sight_name, s.description from city c join famous_sight s on c.city_id = s.city_id where c.city_name = 'porto alegre'
Restaurants in Porto Alegre|select c.city_name, r.rest_name, r.description, r.avg_price_usd from city c join restaurant r on c.city_id = r.city_id where c.city_name = 'porto alegre'
Dishes in Porto Alegre|select f.dish_name, f.description, f.price_usd, r.rest_name, c.city_name from (city c join restaurant r on c.city_id = r.city_id) join food f on f.restaurant_id = r.rest_id where c.city_name = 'porto alegre'
Museums in Salvador|select c.city_name, m.museum_name, m.type, m.description from city c join museum m on c.city_id = m.city_id where c.city_name = 'salvador'
Parks in Salvador|select c.city_name, p.park_name, p.type, p.description from city c join park p on c.city_id = p.city_id where c.city_name = 'salvador'
Famous Sightseeing in Salvador|select c.city_name, s.sight_name, s.description from city c join famous_sight s on c.city_id = s.city_id where c.city_name = 'salvador'
Restaurants in Salvador|select c.city_name, r.rest_name, r.description, r.avg_price_usd from city c join restaurant r on c.city_id = r.city_id where c.city_name = 'salvador'
Dishes in Salvador|select f.dish_name, f.description, f.price_usd, r.rest_name, c.city_name from (city c join restaurant r on c.city_id = r.city_id) join food f on f.restaurant_id = r.rest_id where c.city_name = 'salvador'
Museums in Sofia|select c.city_name, m.museum_name, m.type, m.description from city c join museum m on c.city_id = m.city_id where c.city_name = 'sofia'
Parks in Sofia|select c.city_name, p.park_name, p.type, p.description from city c join park p on c.city_id = p.city_id where c.city_name = 'sofia'
Famous Sightseeing in Sofia|select c.city_name, s.sight_name, s.description from city c join famous_sight s on c.city_id = s.city_id where c.city_name = 'sofia'
Restaurants in Sofia|select c.city_name, r.rest_name, r.description, r.avg_price_usd from city c join restaurant r on c.city_id = r.city_id where c.city_name = 'sofia'
Dishes in Sofia|select f.dish_name, f.description, f.price_usd, r.rest_name, c.city_name from (city c join restaurant r on c.city_id = r.city_id) join food f on f.restaurant_id = r.rest_id where c.city_name = 'sofia'
Museums in Bulgaria|select c.city_name, c.country, m.museum_name, m.type, m.description from city c join museum m on c.city_id = m.city_id where c.country = 'bulgaria'
Parks in Bulgaria|select c.city_name, c.country, p.park_name, p.type, p.description from city c join park p on c.city_id = p.city_id where c.country = 'bulgaria'
Famous Sightseeing in Bulgaria|select c.city_name, c.country, s.sight_name, s.description from city c join famous_sight s on c.city_id = s.city_id where c.country = 'bulgaria'
Restaurants in Bulgaria|select c.city_name, c.country, r.rest_name, r.description, r.avg_price_usd from city c join restaurant r on c.city_id = r.city_id where c.country = 'bulgaria'
Dishes in Bulgaria|select f.dish_name, f.description, f.price_usd, r.rest_name, c.city_name, c.country from (city c join restaurant r on c.city_id = r.city_id) join food f on f.restaurant_id = r.rest_id where c.country = 'bulgaria'
Museums in Yaounde|select c.city_name, m.museum_name, m.type, m.description from city c join museum m on c.city_id = m.city_id where c.city_name = 'yaounde'
Parks in Yaounde|select c.city_name, p.park_name, p.type, p.description from city c join park p on c.city_id = p.city_id where c.city_name = 'yaounde'
Famous Sightseeing in Yaounde|select c.city_name, s.sight_name, s.description from city c join famous_sight s on c.city_id = s.city_id where c.city_name = 'yaounde'
Restaurants in Yaounde|select c.city_name, r.rest_name, r.description, r.avg_price_usd from city c join restaurant r on c.city_id = r.city_id where c.city_name = 'yaounde'
Dishes in Yaounde|select f.dish_name, f.description, f.price_usd, r.rest_name, c.city_name from (city c join restaurant r on c.city_id = r.city_id) join food f on f.restaurant_id = r.rest_id where c.city_name = 'yaounde'
Museums in Cameroon|select c.city_name, c.country, m.museum_name, m.type, m.description from city c join museum m on c.city_id = m.city_id where c.country = 'cameroon'
Parks in Cameroon|select c.city_name, c.country, p.park_name, p.type, p.description from city c join park p on c.city_id = p.city_id where c.country = 'cameroon'
Famous Sightseeing in Cameroon|select c.city_name, c.country, s.sight_name, s.description from city c join famous_sight s on c.city_id = s.city_id where c.country = 'cameroon'
Restaurants in Cameroon|select c.city_name, c.country, r.rest_name, r.description, r.avg_price_usd from city c join restaurant r on c.city_id = r.city_id where c.country = 'cameroon'
Dishes in Cameroon|select f.dish_name, f.description, f.price_usd, r.rest_name, c.city_name, c.country from (city c join restaurant r on c.city_id = r.city_id) join food f on f.restaurant_id = r.rest_id where c.country = 'cameroon'
Museums in Montreal|select c.city_name, m.museum_name, m.type, m.description from city c join museum m on c.city_id = m.city_id where c.city_name = 'montreal'
Parks in Montreal|select c.city_name, p.park_name, p.type, p.description from city c join park p on c.city_id = p.city_id where c.city_name = 'montreal'
Famous Sightseeing in Montreal|select c.city_name, s.sight_name, s.description from city c join famous_sight s on c.city_id = s.city_id where c.city_name = 'montreal'
Restaurants in Montreal|select c.city_name, r.rest_name, r.description, r.avg_price_usd from city c join restaurant r on c.city_id = r.city_id where c.city_name = 'montreal'
Dishes in Montreal|select f.dish_name, f.description, f.price_usd, r.rest_name, c.city_name from (city c join restaurant r on c.city_id = r.city_id) join food f on f.restaurant_id = r.rest_id where c.city_name = 'montreal'
Museums in Canada|select c.city_name, c.country, m.museum_name, m.type, m.description from city c join museum m on c.city_id = m.city_id where c.country = 'canada'
Parks in Canada|select c.city_name, c.country, p.park_name, p.type, p.description from city c join park p on c.city_id = p.city_id where c.country = 'canada'
Famous Sightseeing in Canada|select c.city_name, c.country, s.sight_name, s.description from city c join famous_sight s on c.city_id = s.city_id where c.country = 'canada'
Restaurants in Canada|select c.city_name, c.country, r.rest_name, r.description, r.avg_price_usd from city c join restaurant r on c.city_id = r.city_id where c.country = 'canada'
Dishes in Canada|select f.dish_name, f.description, f.price_usd, r.rest_name, c.city_name, c.country from (city c join restaurant r on c.city_id = r.city_id) join food f on f.restaurant_id = r.rest_id where c.country = 'canada'
Museums in North America|select c.city_name, c.country, c.continent, m.museum_name, m.type, m.description from city c join museum m on c.city_id = m.city_id where c.continent = 'north america'
Parks in North America|select c.city_name, c.country, c.continent, p.park_name, p.type, p.description from city c join park p on c.city_id = p.city_id where c.continent = 'north america'
Famous Sightseeing in North America|select c.city_name, c.country, c.continent, s.sight_name, s.description from city c join famous_sight s on c.city_id = s.city_id where c.continent = 'north america'
Restaurants in North America|select c.city_name, c.country, c.continent, r.rest_name, r.description, r.avg_price_usd from city c join restaurant r on c.city_id = r.city_id where c.continent = 'north america'
Dishes in North America|select f.dish_name, f.description, f.price_usd, r.rest_name, c.city_name, c.country, c.continent from (city c join restaurant r on c.city_id = r.city_id) join food f on f.restaurant_id = r.rest_id where c.continent = 'north america'
Museums in Calgary|select c.city_name, m.museum_name, m.type, m.description from city c join museum m on c.city_id = m.city_id where c.city_name = 'calgary'
Parks in Calgary|select c.city_name, p.park_name, p.type, p.description from city c join park p on c.city_id = p.city_id where c.city_name = 'calgary'
Famous Sightseeing in Calgary|select c.city_name, s.sight_name, s.description from city c join famous_sight s on c.city_id = s.city_id where c.city_name = 'calgary'
Restaurants in Calgary|select c.city_name, r.rest_name, r.description, r.avg_price_usd from city c join restaurant r on c.city_id = r.city_id where c.city_name = 'calgary'
Dishes in Calgary|select f.dish_name, f.description, f.price_usd, r.rest_name, c.city_name from (city c join restaurant r on c.city_id = r.city_id) join food f on f.restaurant_id = r.rest_id where c.city_name = 'calgary'
Museums in Toronto|select c.city_name, m.museum_name, m.type, m.description from city c join museum m on c.city_id = m.city_id where c.city_name = 'toronto'
Parks in Toronto|select c.city_name, p.park_name, p.type, p.description from city c join park p on c.city_id = p.city_id where c.city_name = 'toronto'
Famous Sightseeing in Toronto|select c.city_name, s.sight_name, s.description from city c join famous_sight s on c.city_id = s.city_id where c.city_name = 'toronto'
Restaurants in Toronto|select c.city_name, r.rest_name, r.description, r.avg_price_usd from city c join restaurant r on c.city_id = r.city_id where c.city_name = 'toronto'
Dishes in Toronto|select f.dish_name, f.description, f.price_usd, r.rest_name, c.city_name from (city c join restaurant r on c.city_id = r.city_id) join food f on f.restaurant_id = r.rest_id where c.city_name = 'toronto'
Museums in Shanghai|select c.city_name, m.museum_name, m.type, m.description from city c join museum m on c.city_id = m.city_id where c.city_name = 'shanghai'
Parks in Shanghai|select c.city_name, p.park_name, p.type, p.description from city c join park p on c.city_id = p.city_id where c.city_name = 'shanghai'
Famous Sightseeing in Shanghai|select c.city_name, s.sight_name, s.description from city c join famous_sight s on c.city_id = s.city_id where c.city_name = 'shanghai'
Restaurants in Shanghai|select c.city_name, r.rest_name, r.description, r.avg_price_usd from city c join restaurant r on c.city_id = r.city_id where c.city_name = 'shanghai'
Dishes in Shanghai|select f.dish_name, f.description, f.price_usd, r.rest_name, c.city_name from (city c join restaurant r on c.city_id = r.city_id) join food f on f.restaurant_id = r.rest_id where c.city_name = 'shanghai'
Museums in China|select c.city_name, c.country, m.museum_name, m.type, m.description from city c join museum m on c.city_id = m.city_id where c.country = 'china'
Parks in China|select c.city_name, c.country, p.park_name, p.type, p.description from city c join park p on c.city_id = p.city_id where c.country = 'china'
Famous Sightseeing in China|select c.city_name, c.country, s.sight_name, s.description from city c join famous_sight s on c.city_id = s.city_id where c.country = 'china'
Restaurants in China|select c.city_name, c.country, r.rest_name, r.description, r.avg_price_usd from city c join restaurant r on c.city_id = r.city_id where c.country = 'china'
Dishes in China|select f.dish_name, f.description, f.price_usd, r.rest_name, c.city_name, c.country from (city c join restaurant r on c.city_id = r.city_id) join food f on f.restaurant_id = r.rest_id where c.country = 'china'
Museums in Beijing|select c.city_name, m.museum_name, m.type, m.description from city c join museum m on c.city_id = m.city_id where c.city_name = 'beijing'
Parks in Beijing|select c.city_name, p.park_name, p.type, p.description from city c join park p on c.city_id = p.city_id where c.city_name = 'beijing'
Famous Sightseeing in Beijing|select c.city_name, s.sight_name, s.description from city c join famous_sight s on c.city_id = s.city_id where c.city_name = 'beijing'
Restaurants in Beijing|select c.city_name, r.rest_name, r.description, r.avg_price_usd from city c join restaurant r on c.city_id = r.city_id where c.city_name = 'beijing'
Dishes in Beijing|select f.dish_name, f.description, f.price_usd, r.rest_name, c.city_name from (city c join restaurant r on c.city_id = r.city_id) join food f on f.restaurant_id = r.rest_id where c.city_name = 'beijing'
Museums in Tianjin|select c.city_name, m.museum_name, m.type, m.description from city c join museum m on c.city_id = m.city_id where c.city_name = 'tianjin'
Parks in Tianjin|select c.city_name, p.park_name, p.type, p.description from city c join park p on c.city_id = p.city_id where c.city_name = 'tianjin'
Famous Sightseeing in Tianjin|select c.city_name, s.sight_name, s.description from city c join famous_sight s on c.city_id = s.city_id where c.city_name = 'tianjin'
Restaurants in Tianjin|select c.city_name, r.rest_name, r.description, r.avg_price_usd from city c join restaurant r on c.city_id = r.city_id where c.city_name = 'tianjin'
Dishes in Tianjin|select f.dish_name, f.description, f.price_usd, r.rest_name, c.city_name from (city c join restaurant r on c.city_id = r.city_id) join food f on f.restaurant_id = r.rest_id where c.city_name = 'tianjin'
Museums in Guangzhou|select c.city_name, m.museum_name, m.type, m.description from city c join museum m on c.city_id = m.city_id where c.city_name = 'guangzhou'
Parks in Guangzhou|select c.city_name, p.park_name, p.type, p.description from city c join park p on c.city_id = p.city_id where c.city_name = 'guangzhou'
Famous Sightseeing in Guangzhou|select c.city_name, s.sight_name, s.description from city c join famous_sight s on c.city_id = s.city_id where c.city_name = 'guangzhou'
Restaurants in Guangzhou|select c.city_name, r.rest_name, r.description, r.avg_price_usd from city c join restaurant r on c.city_id = r.city_id where c.city_name = 'guangzhou'
Dishes in Guangzhou|select f.dish_name, f.description, f.price_usd, r.rest_name, c.city_name from (city c join restaurant r on c.city_id = r.city_id) join food f on f.restaurant_id = r.rest_id where c.city_name = 'guangzhou'
Museums in Chengdu|select c.city_name, m.museum_name, m.type, m.description from city c join museum m on c.city_id = m.city_id where c.city_name = 'chengdu'
Parks in Chengdu|select c.city_name, p.park_name, p.type, p.description from city c join park p on c.city_id = p.city_id where c.city_name = 'chengdu'
Famous Sightseeing in Chengdu|select c.city_name, s.sight_name, s.description from city c join famous_sight s on c.city_id = s.city_id where c.city_name = 'chengdu'
Restaurants in Chengdu|select c.city_name, r.rest_name, r.description, r.avg_price_usd from city c join restaurant r on c.city_id = r.city_id where c.city_name = 'chengdu'
Dishes in Chengdu|select f.dish_name, f.description, f.price_usd, r.rest_name, c.city_name from (city c join restaurant r on c.city_id = r.city_id) join food f on f.restaurant_id = r.rest_id where c.city_name = 'chengdu'
Museums in Wuhan|select c.city_name, m.museum_name, m.type, m.description from city c join museum m on c.city_id = m.city_id where c.city_name = 'wuhan'
Parks in Wuhan|select c.city_name, p.park_name, p.type, p.description from city c join park p on c.city_id = p.city_id where c.city_name = 'wuhan'
Famous Sightseeing in Wuhan|select c.city_name, s.sight_name, s.description from city c join famous_sight s on c.city_id = s.city_id where c.city_name = 'wuhan'
Restaurants in Wuhan|select c.city_name, r.rest_name, r.description, r.avg_price_usd from city c join restaurant r on c.city_id = r.city_id where c.city_name = 'wuhan'
Dishes in Wuhan|select f.dish_name, f.description, f.price_usd, r.rest_name, c.city_name from (city c join restaurant r on c.city_id = r.city_id) join food f on f.restaurant_id = r.rest_id where c.city_name = 'wuhan'
Museums in Harbin|select c.city_name, m.museum_name, m.type, m.description from city c join museum m on c.city_id = m.city_id where c.city_name = 'harbin'
Parks in Harbin|select c.city_name, p.park_name, p.type, p.description from city c join park p on c.city_id = p.city_id where c.city_name = 'harbin'
Famous Sightseeing in Harbin|select c.city_name, s.sight_name, s.description from city c join famous_sight s on c.city_id = s.city_id where c.city_name = 'harbin'
Restaurants in Harbin|select c.city_name, r.rest_name, r.description, r.avg_price_usd from city c join restaurant r on c.city_id = r.city_id where c.city_name = 'harbin'
Dishes in Harbin|select f.dish_name, f.description, f.price_usd, r.rest_name, c.city_name from (city c join restaurant r on c.city_id = r.city_id) join food f on f.restaurant_id = r.rest_id where c.city_name = 'harbin'
Museums in Hangzhou|select c.city_name, m.museum_name, m.type, m.description from city c join museum m on c.city_id = m.city_id where c.city_name = 'hangzhou'
Parks in Hangzhou|select c.city_name, p.park_name, p.type, p.description from city c join park p on c.city_id = p.city_id where c.city_name = 'hangzhou'
Famous Sightseeing in Hangzhou|select c.city_name, s.sight_name, s.description from city c join famous_sight s on c.city_id = s.city_id where c.city_name = 'hangzhou'
Restaurants in Hangzhou|select c.city_name, r.rest_name, r.description, r.avg_price_usd from city c join restaurant r on c.city_id = r.city_id where c.city_name = 'hangzhou'
Dishes in Hangzhou|select f.dish_name, f.description, f.price_usd, r.rest_name, c.city_name from (city c join restaurant r on c.city_id = r.city_id) join food f on f.restaurant_id = r.rest_id where c.city_name = 'hangzhou'
Museums in Haikou|select c.city_name, m.museum_name, m.type, m.description from city c join museum m on c.city_id = m.city_id where c.city_name = 'haikou'
Parks in Haikou|select c.city_name, p.park_name, p.type, p.description from city c join park p on c.city_id = p.city_id where c.city_name = 'haikou'
Famous Sightseeing in Haikou|select c.city_name, s.sight_name, s.description from city c join famous_sight s on c.city_id = s.city_id where c.city_name = 'haikou'
Restaurants in Haikou|select c.city_name, r.rest_name, r.description, r.avg_price_usd from city c join restaurant r on c.city_id = r.city_id where c.city_name = 'haikou'
Dishes in Haikou|select f.dish_name, f.description, f.price_usd, r.rest_name, c.city_name from (city c join restaurant r on c.city_id = r.city_id) join food f on f.restaurant_id = r.rest_id where c.city_name = 'haikou'
Museums in Taiyuan|select c.city_name, m.museum_name, m.type, m.description from city c join museum m on c.city_id = m.city_id where c.city_name = 'taiyuan'
Parks in Taiyuan|select c.city_name, p.park_name, p.type, p.description from city c join park p on c.city_id = p.city_id where c.city_name = 'taiyuan'
Famous Sightseeing in Taiyuan|select c.city_name, s.sight_name, s.description from city c join famous_sight s on c.city_id = s.city_id where c.city_name = 'taiyuan'
Restaurants in Taiyuan|select c.city_name, r.rest_name, r.description, r.avg_price_usd from city c join restaurant r on c.city_id = r.city_id where c.city_name = 'taiyuan'
Dishes in Taiyuan|select f.dish_name, f.description, f.price_usd, r.rest_name, c.city_name from (city c join restaurant r on c.city_id = r.city_id) join food f on f.restaurant_id = r.rest_id where c.city_name = 'taiyuan'
Museums in Kunming|select c.city_name, m.museum_name, m.type, m.description from city c join museum m on c.city_id = m.city_id where c.city_name = 'kunming'
Parks in Kunming|select c.city_name, p.park_name, p.type, p.description from city c join park p on c.city_id = p.city_id where c.city_name = 'kunming'
Famous Sightseeing in Kunming|select c.city_name, s.sight_name, s.description from city c join famous_sight s on c.city_id = s.city_id where c.city_name = 'kunming'
Restaurants in Kunming|select c.city_name, r.rest_name, r.description, r.avg_price_usd from city c join restaurant r on c.city_id = r.city_id where c.city_name = 'kunming'
Dishes in Kunming|select f.dish_name, f.description, f.price_usd, r.rest_name, c.city_name from (city c join restaurant r on c.city_id = r.city_id) join food f on f.restaurant_id = r.rest_id where c.city_name = 'kunming'
Museums in Hefei|select c.city_name, m.museum_name, m.type, m.description from city c join museum m on c.city_id = m.city_id where c.city_name = 'hefei'
Parks in Hefei|select c.city_name, p.park_name, p.type, p.description from city c join park p on c.city_id = p.city_id where c.city_name = 'hefei'
Famous Sightseeing in Hefei|select c.city_name, s.sight_name, s.description from city c join famous_sight s on c.city_id = s.city_id where c.city_name = 'hefei'
Restaurants in Hefei|select c.city_name, r.rest_name, r.description, r.avg_price_usd from city c join restaurant r on c.city_id = r.city_id where c.city_name = 'hefei'
Dishes in Hefei|select f.dish_name, f.description, f.price_usd, r.rest_name, c.city_name from (city c join restaurant r on c.city_id = r.city_id) join food f on f.restaurant_id = r.rest_id where c.city_name = 'hefei'
Museums in Shijiazhuang|select c.city_name, m.museum_name, m.type, m.description from city c join museum m on c.city_id = m.city_id where c.city_name = 'shijiazhuang'
Parks in Shijiazhuang|select c.city_name, p.park_name, p.type, p.description from city c join park p on c.city_id = p.city_id where c.city_name = 'shijiazhuang'
Famous Sightseeing in Shijiazhuang|select c.city_name, s.sight_name, s.description from city c join famous_sight s on c.city_id = s.city_id where c.city_name = 'shijiazhuang'
Restaurants in Shijiazhuang|select c.city_name, r.rest_name, r.description, r.avg_price_usd from city c join restaurant r on c.city_id = r.city_id where c.city_name = 'shijiazhuang'
Dishes in Shijiazhuang|select f.dish_name, f.description, f.price_usd, r.rest_name, c.city_name from (city c join restaurant r on c.city_id = r.city_id) join food f on f.restaurant_id = r.rest_id where c.city_name = 'shijiazhuang'
Museums in Changsha|select c.city_name, m.museum_name, m.type, m.description from city c join museum m on c.city_id = m.city_id where c.city_name = 'changsha'
Parks in Changsha|select c.city_name, p.park_name, p.type, p.description from city c join park p on c.city_id = p.city_id where c.city_name = 'changsha'
Famous Sightseeing in Changsha|select c.city_name, s.sight_name, s.description from city c join famous_sight s on c.city_id = s.city_id where c.city_name = 'changsha'
Restaurants in Changsha|select c.city_name, r.rest_name, r.description, r.avg_price_usd from city c join restaurant r on c.city_id = r.city_id where c.city_name = 'changsha'
Dishes in Changsha|select f.dish_name, f.description, f.price_usd, r.rest_name, c.city_name from (city c join restaurant r on c.city_id = r.city_id) join food f on f.restaurant_id = r.rest_id where c.city_name = 'changsha'
Museums in Changchun|select c.city_name, m.museum_name, m.type, m.description from city c join museum m on c.city_id = m.city_id where c.city_name = 'changchun'
Parks in Changchun|select c.city_name, p.park_name, p.type, p.description from city c join park p on c.city_id = p.city_id where c.city_name = 'changchun'
Famous Sightseeing in Changchun|select c.city_name, s.sight_name, s.description from city c join famous_sight s on c.city_id = s.city_id where c.city_name = 'changchun'
Restaurants in Changchun|select c.city_name, r.rest_name, r.description, r.avg_price_usd from city c join restaurant r on c.city_id = r.city_id where c.city_name = 'changchun'
Dishes in Changchun|select f.dish_name, f.description, f.price_usd, r.rest_name, c.city_name from (city c join restaurant r on c.city_id = r.city_id) join food f on f.restaurant_id = r.rest_id where c.city_name = 'changchun'
Museums in Shenzhen|select c.city_name, m.museum_name, m.type, m.description from city c join museum m on c.city_id = m.city_id where c.city_name = 'shenzhen'
Parks in Shenzhen|select c.city_name, p.park_name, p.type, p.description from city c join park p on c.city_id = p.city_id where c.city_name = 'shenzhen'
Famous Sightseeing in Shenzhen|select c.city_name, s.sight_name, s.description from city c join famous_sight s on c.city_id = s.city_id where c.city_name = 'shenzhen'
Restaurants in Shenzhen|select c.city_name, r.rest_name, r.description, r.avg_price_usd from city c join restaurant r on c.city_id = r.city_id where c.city_name = 'shenzhen'
Dishes in Shenzhen|select f.dish_name, f.description, f.price_usd, r.rest_name, c.city_name from (city c join restaurant r on c.city_id = r.city_id) join food f on f.restaurant_id = r.rest_id where c.city_name = 'shenzhen'
Museums in Chongqing|select c.city_name, m.museum_name, m.type, m.description from city c join museum m on c.city_id = m.city_id where c.city_name = 'chongqing'
Parks in Chongqing|select c.city_name, p.park_name, p.type, p.description from city c join park p on c.city_id = p.city_id where c.city_name = 'chongqing'
Famous Sightseeing in Chongqing|select c.city_name, s.sight_name, s.description from city c join famous_sight s on c.city_id = s.city_id where c.city_name = 'chongqing'
Restaurants in Chongqing|select c.city_name, r.rest_name, r.description, r.avg_price_usd from city c join restaurant r on c.city_id = r.city_id where c.city_name = 'chongqing'
Dishes in Chongqing|select f.dish_name, f.description, f.price_usd, r.rest_name, c.city_name from (city c join restaurant r on c.city_id = r.city_id) join food f on f.restaurant_id = r.rest_id where c.city_name = 'chongqing'
Museums in Lanzhou|select c.city_name, m.museum_name, m.type, m.description from city c join museum m on c.city_id = m.city_id where c.city_name = 'lanzhou'
Parks in Lanzhou|select c.city_name, p.park_name, p.type, p.description from city c join park p on c.city_id = p.city_id where c.city_name = 'lanzhou'
Famous Sightseeing in Lanzhou|select c.city_name, s.sight_name, s.description from city c join famous_sight s on c.city_id = s.city_id where c.city_name = 'lanzhou'
Restaurants in Lanzhou|select c.city_name, r.rest_name, r.description, r.avg_price_usd from city c join restaurant r on c.city_id = r.city_id where c.city_name = 'lanzhou'
Dishes in Lanzhou|select f.dish_name, f.description, f.price_usd, r.rest_name, c.city_name from (city c join restaurant r on c.city_id = r.city_id) join food f on f.restaurant_id = r.rest_id where c.city_name = 'lanzhou'
Museums in Nanchang|select c.city_name, m.museum_name, m.type, m.description from city c join museum m on c.city_id = m.city_id where c.city_name = 'nanchang'
Parks in Nanchang|select c.city_name, p.park_name, p.type, p.description from city c join park p on c.city_id = p.city_id where c.city_name = 'nanchang'
Famous Sightseeing in Nanchang|select c.city_name, s.sight_name, s.description from city c join famous_sight s on c.city_id = s.city_id where c.city_name = 'nanchang'
Restaurants in Nanchang|select c.city_name, r.rest_name, r.description, r.avg_price_usd from city c join restaurant r on c.city_id = r.city_id where c.city_name = 'nanchang'
Dishes in Nanchang|select f.dish_name, f.description, f.price_usd, r.rest_name, c.city_name from (city c join restaurant r on c.city_id = r.city_id) join food f on f.restaurant_id = r.rest_id where c.city_name = 'nanchang'
Museums in Dalian|select c.city_name, m.museum_name, m.type, m.description from city c join museum m on c.city_id = m.city_id where c.city_name = 'dalian'
Parks in Dalian|select c.city_name, p.park_name, p.type, p.description from city c join park p on c.city_id = p.city_id where c.city_name = 'dalian'
Famous Sightseeing in Dalian|select c.city_name, s.sight_name, s.description from city c join famous_sight s on c.city_id = s.city_id where c.city_name = 'dalian'
Restaurants in Dalian|select c.city_name, r.rest_name, r.description, r.avg_price_usd from city c join restaurant r on c.city_id = r.city_id where c.city_name = 'dalian'
Dishes in Dalian|select f.dish_name, f.description, f.price_usd, r.rest_name, c.city_name from (city c join restaurant r on c.city_id = r.city_id) join food f on f.restaurant_id = r.rest_id where c.city_name = 'dalian'
Museums in Zhengzhou|select c.city_name, m.museum_name, m.type, m.description from city c join museum m on c.city_id = m.city_id where c.city_name = 'zhengzhou'
Parks in Zhengzhou|select c.city_name, p.park_name, p.type, p.description from city c join park p on c.city_id = p.city_id where c.city_name = 'zhengzhou'
Famous Sightseeing in Zhengzhou|select c.city_name, s.sight_name, s.description from city c join famous_sight s on c.city_id = s.city_id where c.city_name = 'zhengzhou'
Restaurants in Zhengzhou|select c.city_name, r.rest_name, r.description, r.avg_price_usd from city c join restaurant r on c.city_id = r.city_id where c.city_name = 'zhengzhou'
Dishes in Zhengzhou|select f.dish_name, f.description, f.price_usd, r.rest_name, c.city_name from (city c join restaurant r on c.city_id = r.city_id) join food f on f.restaurant_id = r.rest_id where c.city_name = 'zhengzhou'
Museums in Medellin|select c.city_name, m.museum_name, m.type, m.description from city c join museum m on c.city_id = m.city_id where c.city_name = 'medellin'
Parks in Medellin|select c.city_name, p.park_name, p.type, p.description from city c join park p on c.city_id = p.city_id where c.city_name = 'medellin'
Famous Sightseeing in Medellin|select c.city_name, s.sight_name, s.description from city c join famous_sight s on c.city_id = s.city_id where c.city_name = 'medellin'
Restaurants in Medellin|select c.city_name, r.rest_name, r.description, r.avg_price_usd from city c join restaurant r on c.city_id = r.city_id where c.city_name = 'medellin'
Dishes in Medellin|select f.dish_name, f.description, f.price_usd, r.rest_name, c.city_name from (city c join restaurant r on c.city_id = r.city_id) join food f on f.restaurant_id = r.rest_id where c.city_name = 'medellin'
Museums in Colombia|select c.city_name, c.country, m.museum_name, m.type, m.description from city c join museum m on c.city_id = m.city_id where c.country = 'colombia'
Parks in Colombia|select c.city_name, c.country, p.park_name, p.type, p.description from city c join park p on c.city_id = p.city_id where c.country = 'colombia'
Famous Sightseeing in Colombia|select c.city_name, c.country, s.sight_name, s.description from city c join famous_sight s on c.city_id = s.city_id where c.country = 'colombia'
Restaurants in Colombia|select c.city_name, c.country, r.rest_name, r.description, r.avg_price_usd from city c join restaurant r on c.city_id = r.city_id where c.country = 'colombia'
Dishes in Colombia|select f.dish_name, f.description, f.price_usd, r.rest_name, c.city_name, c.country from (city c join restaurant r on c.city_id = r.city_id) join food f on f.restaurant_id = r.rest_id where c.country = 'colombia'
Museums in Bogota|select c.city_name, m.museum_name, m.type, m.description from city c join museum m on c.city_id = m.city_id where c.city_name = 'bogota'
Parks in Bogota|select c.city_name, p.park_name, p.type, p.description from city c join park p on c.city_id = p.city_id where c.city_name = 'bogota'
Famous Sightseeing in Bogota|select c.city_name, s.sight_name, s.description from city c join famous_sight s on c.city_id = s.city_id where c.city_name = 'bogota'
Restaurants in Bogota|select c.city_name, r.rest_name, r.description, r.avg_price_usd from city c join restaurant r on c.city_id = r.city_id where c.city_name = 'bogota'
Dishes in Bogota|select f.dish_name, f.description, f.price_usd, r.rest_name, c.city_name from (city c join restaurant r on c.city_id = r.city_id) join food f on f.restaurant_id = r.rest_id where c.city_name = 'bogota'
Museums in Santo Domingo|select c.city_name, m.museum_name, m.type, m.description from city c join museum m on c.city_id = m.city_id where c.city_name = 'santo domingo'
Parks in Santo Domingo|select c.city_name, p.park_name, p.type, p.description from city c join park p on c.city_id = p.city_id where c.city_name = 'santo domingo'
Famous Sightseeing in Santo Domingo|select c.city_name, s.sight_name, s.description from city c join famous_sight s on c.city_id = s.city_id where c.city_name = 'santo domingo'
Restaurants in Santo Domingo|select c.city_name, r.rest_name, r.description, r.avg_price_usd from city c join restaurant r on c.city_id = r.city_id where c.city_name = 'santo domingo'
Dishes in Santo Domingo|select f.dish_name, f.description, f.price_usd, r.rest_name, c.city_name from (city c join restaurant r on c.city_id = r.city_id) join food f on f.restaurant_id = r.rest_id where c.city_name = 'santo domingo'
Museums in Dominican Republic|select c.city_name, c.country, m.museum_name, m.type, m.description from city c join museum m on c.city_id = m.city_id where c.country = 'dominican republic'
Parks in Dominican Republic|select c.city_name, c.country, p.park_name, p.type, p.description from city c join park p on c.city_id = p.city_id where c.country = 'dominican republic'
Famous Sightseeing in Dominican Republic|select c.city_name, c.country, s.sight_name, s.description from city c join famous_sight s on c.city_id = s.city_id where c.country = 'dominican republic'
Restaurants in Dominican Republic|select c.city_name, c.country, r.rest_name, r.description, r.avg_price_usd from city c join restaurant r on c.city_id = r.city_id where c.country = 'dominican republic'
Dishes in Dominican Republic|select f.dish_name, f.description, f.price_usd, r.rest_name, c.city_name, c.country from (city c join restaurant r on c.city_id = r.city_id) join food f on f.restaurant_id = r.rest_id where c.country = 'dominican republic'
Museums in Quito|select c.city_name, m.museum_name, m.type, m.description from city c join museum m on c.city_id = m.city_id where c.city_name = 'quito'
Parks in Quito|select c.city_name, p.park_name, p.type, p.description from city c join park p on c.city_id = p.city_id where c.city_name = 'quito'
Famous Sightseeing in Quito|select c.city_name, s.sight_name, s.description from city c join famous_sight s on c.city_id = s.city_id where c.city_name = 'quito'
Restaurants in Quito|select c.city_name, r.rest_name, r.description, r.avg_price_usd from city c join restaurant r on c.city_id = r.city_id where c.city_name = 'quito'
Dishes in Quito|select f.dish_name, f.description, f.price_usd, r.rest_name, c.city_name from (city c join restaurant r on c.city_id = r.city_id) join food f on f.restaurant_id = r.rest_id where c.city_name = 'quito'
Museums in Ecuador|select c.city_name, c.country, m.museum_name, m.type, m.description from city c join museum m on c.city_id = m.city_id where c.country = 'ecuador'
Parks in Ecuador|select c.city_name, c.country, p.park_name, p.type, p.description from city c join park p on c.city_id = p.city_id where c.country = 'ecuador'
Famous Sightseeing in Ecuador|select c.city_name, c.country, s.sight_name, s.description from city c join famous_sight s on c.city_id = s.city_id where c.country = 'ecuador'
Restaurants in Ecuador|select c.city_name, c.country, r.rest_name, r.description, r.avg_price_usd from city c join restaurant r on c.city_id = r.city_id where c.country = 'ecuador'
Dishes in Ecuador|select f.dish_name, f.description, f.price_usd, r.rest_name, c.city_name, c.country from (city c join restaurant r on c.city_id = r.city_id) join food f on f.restaurant_id = r.rest_id where c.country = 'ecuador'
Museums in Guayaquil|select c.city_name, m.museum_name, m.type, m.description from city c join museum m on c.city_id = m.city_id where c.city_name = 'guayaquil'
Parks in Guayaquil|select c.city_name, p.park_name, p.type, p.description from city c join park p on c.city_id = p.city_id where c.city_name = 'guayaquil'
Famous Sightseeing in Guayaquil|select c.city_name, s.sight_name, s.description from city c join famous_sight s on c.city_id = s.city_id where c.city_name = 'guayaquil'
Restaurants in Guayaquil|select c.city_name, r.rest_name, r.description, r.avg_price_usd from city c join restaurant r on c.city_id = r.city_id where c.city_name = 'guayaquil'
Dishes in Guayaquil|select f.dish_name, f.description, f.price_usd, r.rest_name, c.city_name from (city c join restaurant r on c.city_id = r.city_id) join food f on f.restaurant_id = r.rest_id where c.city_name = 'guayaquil'
Museums in Cairo|select c.city_name, m.museum_name, m.type, m.description from city c join museum m on c.city_id = m.city_id where c.city_name = 'cairo'
Parks in Cairo|select c.city_name, p.park_name, p.type, p.description from city c join park p on c.city_id = p.city_id where c.city_name = 'cairo'
Famous Sightseeing in Cairo|select c.city_name, s.sight_name, s.description from city c join famous_sight s on c.city_id = s.city_id where c.city_name = 'cairo'
Restaurants in Cairo|select c.city_name, r.rest_name, r.description, r.avg_price_usd from city c join restaurant r on c.city_id = r.city_id where c.city_name = 'cairo'
Dishes in Cairo|select f.dish_name, f.description, f.price_usd, r.rest_name, c.city_name from (city c join restaurant r on c.city_id = r.city_id) join food f on f.restaurant_id = r.rest_id where c.city_name = 'cairo'
Museums in Egypt|select c.city_name, c.country, m.museum_name, m.type, m.description from city c join museum m on c.city_id = m.city_id where c.country = 'egypt'
Parks in Egypt|select c.city_name, c.country, p.park_name, p.type, p.description from city c join park p on c.city_id = p.city_id where c.country = 'egypt'
Famous Sightseeing in Egypt|select c.city_name, c.country, s.sight_name, s.description from city c join famous_sight s on c.city_id = s.city_id where c.country = 'egypt'
Restaurants in Egypt|select c.city_name, c.country, r.rest_name, r.description, r.avg_price_usd from city c join restaurant r on c.city_id = r.city_id where c.country = 'egypt'
Dishes in Egypt|select f.dish_name, f.description, f.price_usd, r.rest_name, c.city_name, c.country from (city c join restaurant r on c.city_id = r.city_id) join food f on f.restaurant_id = r.rest_id where c.country = 'egypt'
Museums in Alexandria|select c.city_name, m.museum_name, m.type, m.description from city c join museum m on c.city_id = m.city_id where c.city_name = 'alexandria'
Parks in Alexandria|select c.city_name, p.park_name, p.type, p.description from city c join park p on c.city_id = p.city_id where c.city_name = 'alexandria'
Famous Sightseeing in Alexandria|select c.city_name, s.sight_name, s.description from city c join famous_sight s on c.city_id = s.city_id where c.city_name = 'alexandria'
Restaurants in Alexandria|select c.city_name, r.rest_name, r.description, r.avg_price_usd from city c join restaurant r on c.city_id = r.city_id where c.city_name = 'alexandria'
Dishes in Alexandria|select f.dish_name, f.description, f.price_usd, r.rest_name, c.city_name from (city c join restaurant r on c.city_id = r.city_id) join food f on f.restaurant_id = r.rest_id where c.city_name = 'alexandria'
Museums in Addis Ababa|select c.city_name, m.museum_name, m.type, m.description from city c join museum m on c.city_id = m.city_id where c.city_name = 'addis ababa'
Parks in Addis Ababa|select c.city_name, p.park_name, p.type, p.description from city c join park p on c.city_id = p.city_id where c.city_name = 'addis ababa'
Famous Sightseeing in Addis Ababa|select c.city_name, s.sight_name, s.description from city c join famous_sight s on c.city_id = s.city_id where c.city_name = 'addis ababa'
Restaurants in Addis Ababa|select c.city_name, r.rest_name, r.description, r.avg_price_usd from city c join restaurant r on c.city_id = r.city_id where c.city_name = 'addis ababa'
Dishes in Addis Ababa|select f.dish_name, f.description, f.price_usd, r.rest_name, c.city_name from (city c join restaurant r on c.city_id = r.city_id) join food f on f.restaurant_id = r.rest_id where c.city_name = 'addis ababa'
Museums in Ethiopia|select c.city_name, c.country, m.museum_name, m.type, m.description from city c join museum m on c.city_id = m.city_id where c.country = 'ethiopia'
Parks in Ethiopia|select c.city_name, c.country, p.park_name, p.type, p.description from city c join park p on c.city_id = p.city_id where c.country = 'ethiopia'
Famous Sightseeing in Ethiopia|select c.city_name, c.country, s.sight_name, s.description from city c join famous_sight s on c.city_id = s.city_id where c.country = 'ethiopia'
Restaurants in Ethiopia|select c.city_name, c.country, r.rest_name, r.description, r.avg_price_usd from city c join restaurant r on c.city_id = r.city_id where c.country = 'ethiopia'
Dishes in Ethiopia|select f.dish_name, f.description, f.price_usd, r.rest_name, c.city_name, c.country from (city c join restaurant r on c.city_id = r.city_id) join food f on f.restaurant_id = r.rest_id where c.country = 'ethiopia'
Museums in Helsinki|select c.city_name, m.museum_name, m.type, m.description from city c join museum m on c.city_id = m.city_id where c.city_name = 'helsinki'
Parks in Helsinki|select c.city_name, p.park_name, p.type, p.description from city c join park p on c.city_id = p.city_id where c.city_name = 'helsinki'
Famous Sightseeing in Helsinki|select c.city_name, s.sight_name, s.description from city c join famous_sight s on c.city_id = s.city_id where c.city_name = 'helsinki'
Restaurants in Helsinki|select c.city_name, r.rest_name, r.description, r.avg_price_usd from city c join restaurant r on c.city_id = r.city_id where c.city_name = 'helsinki'
Dishes in Helsinki|select f.dish_name, f.description, f.price_usd, r.rest_name, c.city_name from (city c join restaurant r on c.city_id = r.city_id) join food f on f.restaurant_id = r.rest_id where c.city_name = 'helsinki'
Museums in Finland|select c.city_name, c.country, m.museum_name, m.type, m.description from city c join museum m on c.city_id = m.city_id where c.country = 'finland'
Parks in Finland|select c.city_name, c.country, p.park_name, p.type, p.description from city c join park p on c.city_id = p.city_id where c.country = 'finland'
Famous Sightseeing in Finland|select c.city_name, c.country, s.sight_name, s.description from city c join famous_sight s on c.city_id = s.city_id where c.country = 'finland'
Restaurants in Finland|select c.city_name, c.country, r.rest_name, r.description, r.avg_price_usd from city c join restaurant r on c.city_id = r.city_id where c.country = 'finland'
Dishes in Finland|select f.dish_name, f.description, f.price_usd, r.rest_name, c.city_name, c.country from (city c join restaurant r on c.city_id = r.city_id) join food f on f.restaurant_id = r.rest_id where c.country = 'finland'
Museums in Paris|select c.city_name, m.museum_name, m.type, m.description from city c join museum m on c.city_id = m.city_id where c.city_name = 'paris'
Parks in Paris|select c.city_name, p.park_name, p.type, p.description from city c join park p on c.city_id = p.city_id where c.city_name = 'paris'
Famous Sightseeing in Paris|select c.city_name, s.sight_name, s.description from city c join famous_sight s on c.city_id = s.city_id where c.city_name = 'paris'
Restaurants in Paris|select c.city_name, r.rest_name, r.description, r.avg_price_usd from city c join restaurant r on c.city_id = r.city_id where c.city_name = 'paris'
Dishes in Paris|select f.dish_name, f.description, f.price_usd, r.rest_name, c.city_name from (city c join restaurant r on c.city_id = r.city_id) join food f on f.restaurant_id = r.rest_id where c.city_name = 'paris'
Museums in France|select c.city_name, c.country, m.museum_name, m.type, m.description from city c join museum m on c.city_id = m.city_id where c.country = 'france'
Parks in France|select c.city_name, c.country, p.park_name, p.type, p.description from city c join park p on c.city_id = p.city_id where c.country = 'france'
Famous Sightseeing in France|select c.city_name, c.country, s.sight_name, s.description from city c join famous_sight s on c.city_id = s.city_id where c.country = 'france'
Restaurants in France|select c.city_name, c.country, r.rest_name, r.description, r.avg_price_usd from city c join restaurant r on c.city_id = r.city_id where c.country = 'france'
Dishes in France|select f.dish_name, f.description, f.price_usd, r.rest_name, c.city_name, c.country from (city c join restaurant r on c.city_id = r.city_id) join food f on f.restaurant_id = r.rest_id where c.country = 'france'
Museums in Lyon|select c.city_name, m.museum_name, m.type, m.description from city c join museum m on c.city_id = m.city_id where c.city_name = 'lyon'
Parks in Lyon|select c.city_name, p.park_name, p.type, p.description from city c join park p on c.city_id = p.city_id where c.city_name = 'lyon'
Famous Sightseeing in Lyon|select c.city_name, s.sight_name, s.description from city c join famous_sight s on c.city_id = s.city_id where c.city_name = 'lyon'
Restaurants in Lyon|select c.city_name, r.rest_name, r.description, r.avg_price_usd from city c join restaurant r on c.city_id = r.city_id where c.city_name = 'lyon'
Dishes in Lyon|select f.dish_name, f.description, f.price_usd, r.rest_name, c.city_name from (city c join restaurant r on c.city_id = r.city_id) join food f on f.restaurant_id = r.rest_id where c.city_name = 'lyon'
Museums in Marseille|select c.city_name, m.museum_name, m.type, m.description from city c join museum m on c.city_id = m.city_id where c.city_name = 'marseille'
Parks in Marseille|select c.city_name, p.park_name, p.type, p.description from city c join park p on c.city_id = p.city_id where c.city_name = 'marseille'
Famous Sightseeing in Marseille|select c.city_name, s.sight_name, s.description from city c join famous_sight s on c.city_id = s.city_id where c.city_name = 'marseille'
Restaurants in Marseille|select c.city_name, r.rest_name, r.description, r.avg_price_usd from city c join restaurant r on c.city_id = r.city_id where c.city_name = 'marseille'
Dishes in Marseille|select f.dish_name, f.description, f.price_usd, r.rest_name, c.city_name from (city c join restaurant r on c.city_id = r.city_id) join food f on f.restaurant_id = r.rest_id where c.city_name = 'marseille'
Museums in Tbilisi|select c.city_name, m.museum_name, m.type, m.description from city c join museum m on c.city_id = m.city_id where c.city_name = 'tbilisi'
Parks in Tbilisi|select c.city_name, p.park_name, p.type, p.description from city c join park p on c.city_id = p.city_id where c.city_name = 'tbilisi'
Famous Sightseeing in Tbilisi|select c.city_name, s.sight_name, s.description from city c join famous_sight s on c.city_id = s.city_id where c.city_name = 'tbilisi'
Restaurants in Tbilisi|select c.city_name, r.rest_name, r.description, r.avg_price_usd from city c join restaurant r on c.city_id = r.city_id where c.city_name = 'tbilisi'
Dishes in Tbilisi|select f.dish_name, f.description, f.price_usd, r.rest_name, c.city_name from (city c join restaurant r on c.city_id = r.city_id) join food f on f.restaurant_id = r.rest_id where c.city_name = 'tbilisi'
Museums in Georgia|select c.city_name, c.country, m.museum_name, m.type, m.description from city c join museum m on c.city_id = m.city_id where c.country = 'georgia'
Parks in Georgia|select c.city_name, c.country, p.park_name, p.type, p.description from city c join park p on c.city_id = p.city_id where c.country = 'georgia'
Famous Sightseeing in Georgia|select c.city_name, c.country, s.sight_name, s.description from city c join famous_sight s on c.city_id = s.city_id where c.country = 'georgia'
Restaurants in Georgia|select c.city_name, c.country, r.rest_name, r.description, r.avg_price_usd from city c join restaurant r on c.city_id = r.city_id where c.country = 'georgia'
Dishes in Georgia|select f.dish_name, f.description, f.price_usd, r.rest_name, c.city_name, c.country from (city c join restaurant r on c.city_id = r.city_id) join food f on f.restaurant_id = r.rest_id where c.country = 'georgia'
Museums in Stuttgart|select c.city_name, m.museum_name, m.type, m.description from city c join museum m on c.city_id = m.city_id where c.city_name = 'stuttgart'
Parks in Stuttgart|select c.city_name, p.park_name, p.type, p.description from city c join park p on c.city_id = p.city_id where c.city_name = 'stuttgart'
Famous Sightseeing in Stuttgart|select c.city_name, s.sight_name, s.description from city c join famous_sight s on c.city_id = s.city_id where c.city_name = 'stuttgart'
Restaurants in Stuttgart|select c.city_name, r.rest_name, r.description, r.avg_price_usd from city c join restaurant r on c.city_id = r.city_id where c.city_name = 'stuttgart'
Dishes in Stuttgart|select f.dish_name, f.description, f.price_usd, r.rest_name, c.city_name from (city c join restaurant r on c.city_id = r.city_id) join food f on f.restaurant_id = r.rest_id where c.city_name = 'stuttgart'
Museums in Germany|select c.city_name, c.country, m.museum_name, m.type, m.description from city c join museum m on c.city_id = m.city_id where c.country = 'germany'
Parks in Germany|select c.city_name, c.country, p.park_name, p.type, p.description from city c join park p on c.city_id = p.city_id where c.country = 'germany'
Famous Sightseeing in Germany|select c.city_name, c.country, s.sight_name, s.description from city c join famous_sight s on c.city_id = s.city_id where c.country = 'germany'
Restaurants in Germany|select c.city_name, c.country, r.rest_name, r.description, r.avg_price_usd from city c join restaurant r on c.city_id = r.city_id where c.country = 'germany'
Dishes in Germany|select f.dish_name, f.description, f.price_usd, r.rest_name, c.city_name, c.country from (city c join restaurant r on c.city_id = r.city_id) join food f on f.restaurant_id = r.rest_id where c.country = 'germany'
Museums in Hamburg|select c.city_name, m.museum_name, m.type, m.description from city c join museum m on c.city_id = m.city_id where c.city_name = 'hamburg'
Parks in Hamburg|select c.city_name, p.park_name, p.type, p.description from city c join park p on c.city_id = p.city_id where c.city_name = 'hamburg'
Famous Sightseeing in Hamburg|select c.city_name, s.sight_name, s.description from city c join famous_sight s on c.city_id = s.city_id where c.city_name = 'hamburg'
Restaurants in Hamburg|select c.city_name, r.rest_name, r.description, r.avg_price_usd from city c join restaurant r on c.city_id = r.city_id where c.city_name = 'hamburg'
Dishes in Hamburg|select f.dish_name, f.description, f.price_usd, r.rest_name, c.city_name from (city c join restaurant r on c.city_id = r.city_id) join food f on f.restaurant_id = r.rest_id where c.city_name = 'hamburg'
Museums in Dusseldorf|select c.city_name, m.museum_name, m.type, m.description from city c join museum m on c.city_id = m.city_id where c.city_name = 'dusseldorf'
Parks in Dusseldorf|select c.city_name, p.park_name, p.type, p.description from city c join park p on c.city_id = p.city_id where c.city_name = 'dusseldorf'
Famous Sightseeing in Dusseldorf|select c.city_name, s.sight_name, s.description from city c join famous_sight s on c.city_id = s.city_id where c.city_name = 'dusseldorf'
Restaurants in Dusseldorf|select c.city_name, r.rest_name, r.description, r.avg_price_usd from city c join restaurant r on c.city_id = r.city_id where c.city_name = 'dusseldorf'
Dishes in Dusseldorf|select f.dish_name, f.description, f.price_usd, r.rest_name, c.city_name from (city c join restaurant r on c.city_id = r.city_id) join food f on f.restaurant_id = r.rest_id where c.city_name = 'dusseldorf'
Museums in Guatemala City|select c.city_name, m.museum_name, m.type, m.description from city c join museum m on c.city_id = m.city_id where c.city_name = 'guatemala city'
Parks in Guatemala City|select c.city_name, p.park_name, p.type, p.description from city c join park p on c.city_id = p.city_id where c.city_name = 'guatemala city'
Famous Sightseeing in Guatemala City|select c.city_name, s.sight_name, s.description from city c join famous_sight s on c.city_id = s.city_id where c.city_name = 'guatemala city'
Restaurants in Guatemala City|select c.city_name, r.rest_name, r.description, r.avg_price_usd from city c join restaurant r on c.city_id = r.city_id where c.city_name = 'guatemala city'
Dishes in Guatemala City|select f.dish_name, f.description, f.price_usd, r.rest_name, c.city_name from (city c join restaurant r on c.city_id = r.city_id) join food f on f.restaurant_id = r.rest_id where c.city_name = 'guatemala city'
Museums in Guatemala|select c.city_name, c.country, m.museum_name, m.type, m.description from city c join museum m on c.city_id = m.city_id where c.country = 'guatemala'
Parks in Guatemala|select c.city_name, c.country, p.park_name, p.type, p.description from city c join park p on c.city_id = p.city_id where c.country = 'guatemala'
Famous Sightseeing in Guatemala|select c.city_name, c.country, s.sight_name, s.description from city c join famous_sight s on c.city_id = s.city_id where c.country = 'guatemala'
Restaurants in Guatemala|select c.city_name, c.country, r.rest_name, r.description, r.avg_price_usd from city c join restaurant r on c.city_id = r.city_id where c.country = 'guatemala'
Dishes in Guatemala|select f.dish_name, f.description, f.price_usd, r.rest_name, c.city_name, c.country from (city c join restaurant r on c.city_id = r.city_id) join food f on f.restaurant_id = r.rest_id where c.country = 'guatemala'
Museums in Delhi|select c.city_name, m.museum_name, m.type, m.description from city c join museum m on c.city_id = m.city_id where c.city_name = 'delhi'
Parks in Delhi|select c.city_name, p.park_name, p.type, p.description from city c join park p on c.city_id = p.city_id where c.city_name = 'delhi'
Famous Sightseeing in Delhi|select c.city_name, s.sight_name, s.description from city c join famous_sight s on c.city_id = s.city_id where c.city_name = 'delhi'
Restaurants in Delhi|select c.city_name, r.rest_name, r.description, r.avg_price_usd from city c join restaurant r on c.city_id = r.city_id where c.city_name = 'delhi'
Dishes in Delhi|select f.dish_name, f.description, f.price_usd, r.rest_name, c.city_name from (city c join restaurant r on c.city_id = r.city_id) join food f on f.restaurant_id = r.rest_id where c.city_name = 'delhi'
Museums in India|select c.city_name, c.country, m.museum_name, m.type, m.description from city c join museum m on c.city_id = m.city_id where c.country = 'india'
Parks in India|select c.city_name, c.country, p.park_name, p.type, p.description from city c join park p on c.city_id = p.city_id where c.country = 'india'
Famous Sightseeing in India|select c.city_name, c.country, s.sight_name, s.description from city c join famous_sight s on c.city_id = s.city_id where c.country = 'india'
Restaurants in India|select c.city_name, c.country, r.rest_name, r.description, r.avg_price_usd from city c join restaurant r on c.city_id = r.city_id where c.country = 'india'
Dishes in India|select f.dish_name, f.description, f.price_usd, r.rest_name, c.city_name, c.country from (city c join restaurant r on c.city_id = r.city_id) join food f on f.restaurant_id = r.rest_id where c.country = 'india'
Museums in Mumbai|select c.city_name, m.museum_name, m.type, m.description from city c join museum m on c.city_id = m.city_id where c.city_name = 'mumbai'
Parks in Mumbai|select c.city_name, p.park_name, p.type, p.description from city c join park p on c.city_id = p.city_id where c.city_name = 'mumbai'
Famous Sightseeing in Mumbai|select c.city_name, s.sight_name, s.description from city c join famous_sight s on c.city_id = s.city_id where c.city_name = 'mumbai'
Restaurants in Mumbai|select c.city_name, r.rest_name, r.description, r.avg_price_usd from city c join restaurant r on c.city_id = r.city_id where c.city_name = 'mumbai'
Dishes in Mumbai|select f.dish_name, f.description, f.price_usd, r.rest_name, c.city_name from (city c join restaurant r on c.city_id = r.city_id) join food f on f.restaurant_id = r.rest_id where c.city_name = 'mumbai'
Museums in Bengaluru|select c.city_name, m.museum_name, m.type, m.description from city c join museum m on c.city_id = m.city_id where c.city_name = 'bengaluru'
Parks in Bengaluru|select c.city_name, p.park_name, p.type, p.description from city c join park p on c.city_id = p.city_id where c.city_name = 'bengaluru'
Famous Sightseeing in Bengaluru|select c.city_name, s.sight_name, s.description from city c join famous_sight s on c.city_id = s.city_id where c.city_name = 'bengaluru'
Restaurants in Bengaluru|select c.city_name, r.rest_name, r.description, r.avg_price_usd from city c join restaurant r on c.city_id = r.city_id where c.city_name = 'bengaluru'
Dishes in Bengaluru|select f.dish_name, f.description, f.price_usd, r.rest_name, c.city_name from (city c join restaurant r on c.city_id = r.city_id) join food f on f.restaurant_id = r.rest_id where c.city_name = 'bengaluru'
Museums in Hyderabad|select c.city_name, m.museum_name, m.type, m.description from city c join museum m on c.city_id = m.city_id where c.city_name = 'hyderabad'
Parks in Hyderabad|select c.city_name, p.park_name, p.type, p.description from city c join park p on c.city_id = p.city_id where c.city_name = 'hyderabad'
Famous Sightseeing in Hyderabad|select c.city_name, s.sight_name, s.description from city c join famous_sight s on c.city_id = s.city_id where c.city_name = 'hyderabad'
Restaurants in Hyderabad|select c.city_name, r.rest_name, r.description, r.avg_price_usd from city c join restaurant r on c.city_id = r.city_id where c.city_name = 'hyderabad'
Dishes in Hyderabad|select f.dish_name, f.description, f.price_usd, r.rest_name, c.city_name from (city c join restaurant r on c.city_id = r.city_id) join food f on f.restaurant_id = r.rest_id where c.city_name = 'hyderabad'
Museums in Chennai|select c.city_name, m.museum_name, m.type, m.description from city c join museum m on c.city_id = m.city_id where c.city_name = 'chennai'
Parks in Chennai|select c.city_name, p.park_name, p.type, p.description from city c join park p on c.city_id = p.city_id where c.city_name = 'chennai'
Famous Sightseeing in Chennai|select c.city_name, s.sight_name, s.description from city c join famous_sight s on c.city_id = s.city_id where c.city_name = 'chennai'
Restaurants in Chennai|select c.city_name, r.rest_name, r.description, r.avg_price_usd from city c join restaurant r on c.city_id = r.city_id where c.city_name = 'chennai'
Dishes in Chennai|select f.dish_name, f.description, f.price_usd, r.rest_name, c.city_name from (city c join restaurant r on c.city_id = r.city_id) join food f on f.restaurant_id = r.rest_id where c.city_name = 'chennai'
Museums in Pune|select c.city_name, m.museum_name, m.type, m.description from city c join museum m on c.city_id = m.city_id where c.city_name = 'pune'
Parks in Pune|select c.city_name, p.park_name, p.type, p.description from city c join park p on c.city_id = p.city_id where c.city_name = 'pune'
Famous Sightseeing in Pune|select c.city_name, s.sight_name, s.description from city c join famous_sight s on c.city_id = s.city_id where c.city_name = 'pune'
Restaurants in Pune|select c.city_name, r.rest_name, r.description, r.avg_price_usd from city c join restaurant r on c.city_id = r.city_id where c.city_name = 'pune'
Dishes in Pune|select f.dish_name, f.description, f.price_usd, r.rest_name, c.city_name from (city c join restaurant r on c.city_id = r.city_id) join food f on f.restaurant_id = r.rest_id where c.city_name = 'pune'
Museums in Ahmedabad|select c.city_name, m.museum_name, m.type, m.description from city c join museum m on c.city_id = m.city_id where c.city_name = 'ahmedabad'
Parks in Ahmedabad|select c.city_name, p.park_name, p.type, p.description from city c join park p on c.city_id = p.city_id where c.city_name = 'ahmedabad'
Famous Sightseeing in Ahmedabad|select c.city_name, s.sight_name, s.description from city c join famous_sight s on c.city_id = s.city_id where c.city_name = 'ahmedabad'
Restaurants in Ahmedabad|select c.city_name, r.rest_name, r.description, r.avg_price_usd from city c join restaurant r on c.city_id = r.city_id where c.city_name = 'ahmedabad'
Dishes in Ahmedabad|select f.dish_name, f.description, f.price_usd, r.rest_name, c.city_name from (city c join restaurant r on c.city_id = r.city_id) join food f on f.restaurant_id = r.rest_id where c.city_name = 'ahmedabad'
Museums in Jaipur|select c.city_name, m.museum_name, m.type, m.description from city c join museum m on c.city_id = m.city_id where c.city_name = 'jaipur'
Parks in Jaipur|select c.city_name, p.park_name, p.type, p.description from city c join park p on c.city_id = p.city_id where c.city_name = 'jaipur'
Famous Sightseeing in Jaipur|select c.city_name, s.sight_name, s.description from city c join famous_sight s on c.city_id = s.city_id where c.city_name = 'jaipur'
Restaurants in Jaipur|select c.city_name, r.rest_name, r.description, r.avg_price_usd from city c join restaurant r on c.city_id = r.city_id where c.city_name = 'jaipur'
Dishes in Jaipur|select f.dish_name, f.description, f.price_usd, r.rest_name, c.city_name from (city c join restaurant r on c.city_id = r.city_id) join food f on f.restaurant_id = r.rest_id where c.city_name = 'jaipur'
Museums in Lucknow|select c.city_name, m.museum_name, m.type, m.description from city c join museum m on c.city_id = m.city_id where c.city_name = 'lucknow'
Parks in Lucknow|select c.city_name, p.park_name, p.type, p.description from city c join park p on c.city_id = p.city_id where c.city_name = 'lucknow'
Famous Sightseeing in Lucknow|select c.city_name, s.sight_name, s.description from city c join famous_sight s on c.city_id = s.city_id where c.city_name = 'lucknow'
Restaurants in Lucknow|select c.city_name, r.rest_name, r.description, r.avg_price_usd from city c join restaurant r on c.city_id = r.city_id where c.city_name = 'lucknow'
Dishes in Lucknow|select f.dish_name, f.description, f.price_usd, r.rest_name, c.city_name from (city c join restaurant r on c.city_id = r.city_id) join food f on f.restaurant_id = r.rest_id where c.city_name = 'lucknow'
Museums in Jakarta|select c.city_name, m.museum_name, m.type, m.description from city c join museum m on c.city_id = m.city_id where c.city_name = 'jakarta'
Parks in Jakarta|select c.city_name, p.park_name, p.type, p.description from city c join park p on c.city_id = p.city_id where c.city_name = 'jakarta'
Famous Sightseeing in Jakarta|select c.city_name, s.sight_name, s.description from city c join famous_sight s on c.city_id = s.city_id where c.city_name = 'jakarta'
Restaurants in Jakarta|select c.city_name, r.rest_name, r.description, r.avg_price_usd from city c join restaurant r on c.city_id = r.city_id where c.city_name = 'jakarta'
Dishes in Jakarta|select f.dish_name, f.description, f.price_usd, r.rest_name, c.city_name from (city c join restaurant r on c.city_id = r.city_id) join food f on f.restaurant_id = r.rest_id where c.city_name = 'jakarta'
Museums in Indonesia|select c.city_name, c.country, m.museum_name, m.type, m.description from city c join museum m on c.city_id = m.city_id where c.country = 'indonesia'
Parks in Indonesia|select c.city_name, c.country, p.park_name, p.type, p.description from city c join park p on c.city_id = p.city_id where c.country = 'indonesia'
Famous Sightseeing in Indonesia|select c.city_name, c.country, s.sight_name, s.description from city c join famous_sight s on c.city_id = s.city_id where c.country = 'indonesia'
Restaurants in Indonesia|select c.city_name, c.country, r.rest_name, r.description, r.avg_price_usd from city c join restaurant r on c.city_id = r.city_id where c.country = 'indonesia'
Dishes in Indonesia|select f.dish_name, f.description, f.price_usd, r.rest_name, c.city_name, c.country from (city c join restaurant r on c.city_id = r.city_id) join food f on f.restaurant_id = r.rest_id where c.country = 'indonesia'
Museums in Surabaya|select c.city_name, m.museum_name, m.type, m.description from city c join museum m on c.city_id = m.city_id where c.city_name = 'surabaya'
Parks in Surabaya|select c.city_name, p.park_name, p.type, p.description from city c join park p on c.city_id = p.city_id where c.city_name = 'surabaya'
Famous Sightseeing in Surabaya|select c.city_name, s.sight_name, s.description from city c join famous_sight s on c.city_id = s.city_id where c.city_name = 'surabaya'
Restaurants in Surabaya|select c.city_name, r.rest_name, r.description, r.avg_price_usd from city c join restaurant r on c.city_id = r.city_id where c.city_name = 'surabaya'
Dishes in Surabaya|select f.dish_name, f.description, f.price_usd, r.rest_name, c.city_name from (city c join restaurant r on c.city_id = r.city_id) join food f on f.restaurant_id = r.rest_id where c.city_name = 'surabaya'
Museums in Makassar|select c.city_name, m.museum_name, m.type, m.description from city c join museum m on c.city_id = m.city_id where c.city_name = 'makassar'
Parks in Makassar|select c.city_name, p.park_name, p.type, p.description from city c join park p on c.city_id = p.city_id where c.city_name = 'makassar'
Famous Sightseeing in Makassar|select c.city_name, s.sight_name, s.description from city c join famous_sight s on c.city_id = s.city_id where c.city_name = 'makassar'
Restaurants in Makassar|select c.city_name, r.rest_name, r.description, r.avg_price_usd from city c join restaurant r on c.city_id = r.city_id where c.city_name = 'makassar'
Dishes in Makassar|select f.dish_name, f.description, f.price_usd, r.rest_name, c.city_name from (city c join restaurant r on c.city_id = r.city_id) join food f on f.restaurant_id = r.rest_id where c.city_name = 'makassar'
Museums in Tehran|select c.city_name, m.museum_name, m.type, m.description from city c join museum m on c.city_id = m.city_id where c.city_name = 'tehran'
Parks in Tehran|select c.city_name, p.park_name, p.type, p.description from city c join park p on c.city_id = p.city_id where c.city_name = 'tehran'
Famous Sightseeing in Tehran|select c.city_name, s.sight_name, s.description from city c join famous_sight s on c.city_id = s.city_id where c.city_name = 'tehran'
Restaurants in Tehran|select c.city_name, r.rest_name, r.description, r.avg_price_usd from city c join restaurant r on c.city_id = r.city_id where c.city_name = 'tehran'
Dishes in Tehran|select f.dish_name, f.description, f.price_usd, r.rest_name, c.city_name from (city c join restaurant r on c.city_id = r.city_id) join food f on f.restaurant_id = r.rest_id where c.city_name = 'tehran'
Museums in Iran|select c.city_name, c.country, m.museum_name, m.type, m.description from city c join museum m on c.city_id = m.city_id where c.country = 'iran'
Parks in Iran|select c.city_name, c.country, p.park_name, p.type, p.description from city c join park p on c.city_id = p.city_id where c.country = 'iran'
Famous Sightseeing in Iran|select c.city_name, c.country, s.sight_name, s.description from city c join famous_sight s on c.city_id = s.city_id where c.country = 'iran'
Restaurants in Iran|select c.city_name, c.country, r.rest_name, r.description, r.avg_price_usd from city c join restaurant r on c.city_id = r.city_id where c.country = 'iran'
Dishes in Iran|select f.dish_name, f.description, f.price_usd, r.rest_name, c.city_name, c.country from (city c join restaurant r on c.city_id = r.city_id) join food f on f.restaurant_id = r.rest_id where c.country = 'iran'
Museums in Mashhad|select c.city_name, m.museum_name, m.type, m.description from city c join museum m on c.city_id = m.city_id where c.city_name = 'mashhad'
Parks in Mashhad|select c.city_name, p.park_name, p.type, p.description from city c join park p on c.city_id = p.city_id where c.city_name = 'mashhad'
Famous Sightseeing in Mashhad|select c.city_name, s.sight_name, s.description from city c join famous_sight s on c.city_id = s.city_id where c.city_name = 'mashhad'
Restaurants in Mashhad|select c.city_name, r.rest_name, r.description, r.avg_price_usd from city c join restaurant r on c.city_id = r.city_id where c.city_name = 'mashhad'
Dishes in Mashhad|select f.dish_name, f.description, f.price_usd, r.rest_name, c.city_name from (city c join restaurant r on c.city_id = r.city_id) join food f on f.restaurant_id = r.rest_id where c.city_name = 'mashhad'
Museums in Tabriz|select c.city_name, m.museum_name, m.type, m.description from city c join museum m on c.city_id = m.city_id where c.city_name = 'tabriz'
Parks in Tabriz|select c.city_name, p.park_name, p.type, p.description from city c join park p on c.city_id = p.city_id where c.city_name = 'tabriz'
Famous Sightseeing in Tabriz|select c.city_name, s.sight_name, s.description from city c join famous_sight s on c.city_id = s.city_id where c.city_name = 'tabriz'
Restaurants in Tabriz|select c.city_name, r.rest_name, r.description, r.avg_price_usd from city c join restaurant r on c.city_id = r.city_id where c.city_name = 'tabriz'
Dishes in Tabriz|select f.dish_name, f.description, f.price_usd, r.rest_name, c.city_name from (city c join restaurant r on c.city_id = r.city_id) join food f on f.restaurant_id = r.rest_id where c.city_name = 'tabriz'
Museums in Baghdad|select c.city_name, m.museum_name, m.type, m.description from city c join museum m on c.city_id = m.city_id where c.city_name = 'baghdad'
Parks in Baghdad|select c.city_name, p.park_name, p.type, p.description from city c join park p on c.city_id = p.city_id where c.city_name = 'baghdad'
Famous Sightseeing in Baghdad|select c.city_name, s.sight_name, s.description from city c join famous_sight s on c.city_id = s.city_id where c.city_name = 'baghdad'
Restaurants in Baghdad|select c.city_name, r.rest_name, r.description, r.avg_price_usd from city c join restaurant r on c.city_id = r.city_id where c.city_name = 'baghdad'
Dishes in Baghdad|select f.dish_name, f.description, f.price_usd, r.rest_name, c.city_name from (city c join restaurant r on c.city_id = r.city_id) join food f on f.restaurant_id = r.rest_id where c.city_name = 'baghdad'
Museums in Iraq|select c.city_name, c.country, m.museum_name, m.type, m.description from city c join museum m on c.city_id = m.city_id where c.country = 'iraq'
Parks in Iraq|select c.city_name, c.country, p.park_name, p.type, p.description from city c join park p on c.city_id = p.city_id where c.country = 'iraq'
Famous Sightseeing in Iraq|select c.city_name, c.country, s.sight_name, s.description from city c join famous_sight s on c.city_id = s.city_id where c.country = 'iraq'
Restaurants in Iraq|select c.city_name, c.country, r.rest_name, r.description, r.avg_price_usd from city c join restaurant r on c.city_id = r.city_id where c.country = 'iraq'
Dishes in Iraq|select f.dish_name, f.description, f.price_usd, r.rest_name, c.city_name, c.country from (city c join restaurant r on c.city_id = r.city_id) join food f on f.restaurant_id = r.rest_id where c.country = 'iraq'
Museums in Mosul|select c.city_name, m.museum_name, m.type, m.description from city c join museum m on c.city_id = m.city_id where c.city_name = 'mosul'
Parks in Mosul|select c.city_name, p.park_name, p.type, p.description from city c join park p on c.city_id = p.city_id where c.city_name = 'mosul'
Famous Sightseeing in Mosul|select c.city_name, s.sight_name, s.description from city c join famous_sight s on c.city_id = s.city_id where c.city_name = 'mosul'
Restaurants in Mosul|select c.city_name, r.rest_name, r.description, r.avg_price_usd from city c join restaurant r on c.city_id = r.city_id where c.city_name = 'mosul'
Dishes in Mosul|select f.dish_name, f.description, f.price_usd, r.rest_name, c.city_name from (city c join restaurant r on c.city_id = r.city_id) join food f on f.restaurant_id = r.rest_id where c.city_name = 'mosul'
Museums in Rome|select c.city_name, m.museum_name, m.type, m.description from city c join museum m on c.city_id = m.city_id where c.city_name = 'rome'
Parks in Rome|select c.city_name, p.park_name, p.type, p.description from city c join park p on c.city_id = p.city_id where c.city_name = 'rome'
Famous Sightseeing in Rome|select c.city_name, s.sight_name, s.description from city c join famous_sight s on c.city_id = s.city_id where c.city_name = 'rome'
Restaurants in Rome|select c.city_name, r.rest_name, r.description, r.avg_price_usd from city c join restaurant r on c.city_id = r.city_id where c.city_name = 'rome'
Dishes in Rome|select f.dish_name, f.description, f.price_usd, r.rest_name, c.city_name from (city c join restaurant r on c.city_id = r.city_id) join food f on f.restaurant_id = r.rest_id where c.city_name = 'rome'
Museums in Italy|select c.city_name, c.country, m.museum_name, m.type, m.description from city c join museum m on c.city_id = m.city_id where c.country = 'italy'
Parks in Italy|select c.city_name, c.country, p.park_name, p.type, p.description from city c join park p on c.city_id = p.city_id where c.country = 'italy'
Famous Sightseeing in Italy|select c.city_name, c.country, s.sight_name, s.description from city c join famous_sight s on c.city_id = s.city_id where c.country = 'italy'
Restaurants in Italy|select c.city_name, c.country, r.rest_name, r.description, r.avg_price_usd from city c join restaurant r on c.city_id = r.city_id where c.country = 'italy'
Dishes in Italy|select f.dish_name, f.description, f.price_usd, r.rest_name, c.city_name, c.country from (city c join restaurant r on c.city_id = r.city_id) join food f on f.restaurant_id = r.rest_id where c.country = 'italy'
Museums in Milan|select c.city_name, m.museum_name, m.type, m.description from city c join museum m on c.city_id = m.city_id where c.city_name = 'milan'
Parks in Milan|select c.city_name, p.park_name, p.type, p.description from city c join park p on c.city_id = p.city_id where c.city_name = 'milan'
Famous Sightseeing in Milan|select c.city_name, s.sight_name, s.description from city c join famous_sight s on c.city_id = s.city_id where c.city_name = 'milan'
Restaurants in Milan|select c.city_name, r.rest_name, r.description, r.avg_price_usd from city c join restaurant r on c.city_id = r.city_id where c.city_name = 'milan'
Dishes in Milan|select f.dish_name, f.description, f.price_usd, r.rest_name, c.city_name from (city c join restaurant r on c.city_id = r.city_id) join food f on f.restaurant_id = r.rest_id where c.city_name = 'milan'
Museums in Abidjan|select c.city_name, m.museum_name, m.type, m.description from city c join museum m on c.city_id = m.city_id where c.city_name = 'abidjan'
Parks in Abidjan|select c.city_name, p.park_name, p.type, p.description from city c join park p on c.city_id = p.city_id where c.city_name = 'abidjan'
Famous Sightseeing in Abidjan|select c.city_name, s.sight_name, s.description from city c join famous_sight s on c.city_id = s.city_id where c.city_name = 'abidjan'
Restaurants in Abidjan|select c.city_name, r.rest_name, r.description, r.avg_price_usd from city c join restaurant r on c.city_id = r.city_id where c.city_name = 'abidjan'
Dishes in Abidjan|select f.dish_name, f.description, f.price_usd, r.rest_name, c.city_name from (city c join restaurant r on c.city_id = r.city_id) join food f on f.restaurant_id = r.rest_id where c.city_name = 'abidjan'
Museums in Ivory Coast|select c.city_name, c.country, m.museum_name, m.type, m.description from city c join museum m on c.city_id = m.city_id where c.country = 'ivory coast'
Parks in Ivory Coast|select c.city_name, c.country, p.park_name, p.type, p.description from city c join park p on c.city_id = p.city_id where c.country = 'ivory coast'
Famous Sightseeing in Ivory Coast|select c.city_name, c.country, s.sight_name, s.description from city c join famous_sight s on c.city_id = s.city_id where c.country = 'ivory coast'
Restaurants in Ivory Coast|select c.city_name, c.country, r.rest_name, r.description, r.avg_price_usd from city c join restaurant r on c.city_id = r.city_id where c.country = 'ivory coast'
Dishes in Ivory Coast|select f.dish_name, f.description, f.price_usd, r.rest_name, c.city_name, c.country from (city c join restaurant r on c.city_id = r.city_id) join food f on f.restaurant_id = r.rest_id where c.country = 'ivory coast'
Museums in Tokyo|select c.city_name, m.museum_name, m.type, m.description from city c join museum m on c.city_id = m.city_id where c.city_name = 'tokyo'
Parks in Tokyo|select c.city_name, p.park_name, p.type, p.description from city c join park p on c.city_id = p.city_id where c.city_name = 'tokyo'
Famous Sightseeing in Tokyo|select c.city_name, s.sight_name, s.description from city c join famous_sight s on c.city_id = s.city_id where c.city_name = 'tokyo'
Restaurants in Tokyo|select c.city_name, r.rest_name, r.description, r.avg_price_usd from city c join restaurant r on c.city_id = r.city_id where c.city_name = 'tokyo'
Dishes in Tokyo|select f.dish_name, f.description, f.price_usd, r.rest_name, c.city_name from (city c join restaurant r on c.city_id = r.city_id) join food f on f.restaurant_id = r.rest_id where c.city_name = 'tokyo'
Museums in Japan|select c.city_name, c.country, m.museum_name, m.type, m.description from city c join museum m on c.city_id = m.city_id where c.country = 'japan'
Parks in Japan|select c.city_name, c.country, p.park_name, p.type, p.description from city c join park p on c.city_id = p.city_id where c.country = 'japan'
Famous Sightseeing in Japan|select c.city_name, c.country, s.sight_name, s.description from city c join famous_sight s on c.city_id = s.city_id where c.country = 'japan'
Restaurants in Japan|select c.city_name, c.country, r.rest_name, r.description, r.avg_price_usd from city c join restaurant r on c.city_id = r.city_id where c.country = 'japan'
Dishes in Japan|select f.dish_name, f.description, f.price_usd, r.rest_name, c.city_name, c.country from (city c join restaurant r on c.city_id = r.city_id) join food f on f.restaurant_id = r.rest_id where c.country = 'japan'
Museums in Fukuoka|select c.city_name, m.museum_name, m.type, m.description from city c join museum m on c.city_id = m.city_id where c.city_name = 'fukuoka'
Parks in Fukuoka|select c.city_name, p.park_name, p.type, p.description from city c join park p on c.city_id = p.city_id where c.city_name = 'fukuoka'
Famous Sightseeing in Fukuoka|select c.city_name, s.sight_name, s.description from city c join famous_sight s on c.city_id = s.city_id where c.city_name = 'fukuoka'
Restaurants in Fukuoka|select c.city_name, r.rest_name, r.description, r.avg_price_usd from city c join restaurant r on c.city_id = r.city_id where c.city_name = 'fukuoka'
Dishes in Fukuoka|select f.dish_name, f.description, f.price_usd, r.rest_name, c.city_name from (city c join restaurant r on c.city_id = r.city_id) join food f on f.restaurant_id = r.rest_id where c.city_name = 'fukuoka'
Museums in Sapporo|select c.city_name, m.museum_name, m.type, m.description from city c join museum m on c.city_id = m.city_id where c.city_name = 'sapporo'
Parks in Sapporo|select c.city_name, p.park_name, p.type, p.description from city c join park p on c.city_id = p.city_id where c.city_name = 'sapporo'
Famous Sightseeing in Sapporo|select c.city_name, s.sight_name, s.description from city c join famous_sight s on c.city_id = s.city_id where c.city_name = 'sapporo'
Restaurants in Sapporo|select c.city_name, r.rest_name, r.description, r.avg_price_usd from city c join restaurant r on c.city_id = r.city_id where c.city_name = 'sapporo'
Dishes in Sapporo|select f.dish_name, f.description, f.price_usd, r.rest_name, c.city_name from (city c join restaurant r on c.city_id = r.city_id) join food f on f.restaurant_id = r.rest_id where c.city_name = 'sapporo'
Museums in Osaka|select c.city_name, m.museum_name, m.type, m.description from city c join museum m on c.city_id = m.city_id where c.city_name = 'osaka'
Parks in Osaka|select c.city_name, p.park_name, p.type, p.description from city c join park p on c.city_id = p.city_id where c.city_name = 'osaka'
Famous Sightseeing in Osaka|select c.city_name, s.sight_name, s.description from city c join famous_sight s on c.city_id = s.city_id where c.city_name = 'osaka'
Restaurants in Osaka|select c.city_name, r.rest_name, r.description, r.avg_price_usd from city c join restaurant r on c.city_id = r.city_id where c.city_name = 'osaka'
Dishes in Osaka|select f.dish_name, f.description, f.price_usd, r.rest_name, c.city_name from (city c join restaurant r on c.city_id = r.city_id) join food f on f.restaurant_id = r.rest_id where c.city_name = 'osaka'
Museums in Hiroshima|select c.city_name, m.museum_name, m.type, m.description from city c join museum m on c.city_id = m.city_id where c.city_name = 'hiroshima'
Parks in Hiroshima|select c.city_name, p.park_name, p.type, p.description from city c join park p on c.city_id = p.city_id where c.city_name = 'hiroshima'
Famous Sightseeing in Hiroshima|select c.city_name, s.sight_name, s.description from city c join famous_sight s on c.city_id = s.city_id where c.city_name = 'hiroshima'
Restaurants in Hiroshima|select c.city_name, r.rest_name, r.description, r.avg_price_usd from city c join restaurant r on c.city_id = r.city_id where c.city_name = 'hiroshima'
Dishes in Hiroshima|select f.dish_name, f.description, f.price_usd, r.rest_name, c.city_name from (city c join restaurant r on c.city_id = r.city_id) join food f on f.restaurant_id = r.rest_id where c.city_name = 'hiroshima'
Museums in Amman|select c.city_name, m.museum_name, m.type, m.description from city c join museum m on c.city_id = m.city_id where c.city_name = 'amman'
Parks in Amman|select c.city_name, p.park_name, p.type, p.description from city c join park p on c.city_id = p.city_id where c.city_name = 'amman'
Famous Sightseeing in Amman|select c.city_name, s.sight_name, s.description from city c join famous_sight s on c.city_id = s.city_id where c.city_name = 'amman'
Restaurants in Amman|select c.city_name, r.rest_name, r.description, r.avg_price_usd from city c join restaurant r on c.city_id = r.city_id where c.city_name = 'amman'
Dishes in Amman|select f.dish_name, f.description, f.price_usd, r.rest_name, c.city_name from (city c join restaurant r on c.city_id = r.city_id) join food f on f.restaurant_id = r.rest_id where c.city_name = 'amman'
Museums in Jordan|select c.city_name, c.country, m.museum_name, m.type, m.description from city c join museum m on c.city_id = m.city_id where c.country = 'jordan'
Parks in Jordan|select c.city_name, c.country, p.park_name, p.type, p.description from city c join park p on c.city_id = p.city_id where c.country = 'jordan'
Famous Sightseeing in Jordan|select c.city_name, c.country, s.sight_name, s.description from city c join famous_sight s on c.city_id = s.city_id where c.country = 'jordan'
Restaurants in Jordan|select c.city_name, c.country, r.rest_name, r.description, r.avg_price_usd from city c join restaurant r on c.city_id = r.city_id where c.country = 'jordan'
Dishes in Jordan|select f.dish_name, f.description, f.price_usd, r.rest_name, c.city_name, c.country from (city c join restaurant r on c.city_id = r.city_id) join food f on f.restaurant_id = r.rest_id where c.country = 'jordan'
Museums in Nairobi|select c.city_name, m.museum_name, m.type, m.description from city c join museum m on c.city_id = m.city_id where c.city_name = 'nairobi'
Parks in Nairobi|select c.city_name, p.park_name, p.type, p.description from city c join park p on c.city_id = p.city_id where c.city_name = 'nairobi'
Famous Sightseeing in Nairobi|select c.city_name, s.sight_name, s.description from city c join famous_sight s on c.city_id = s.city_id where c.city_name = 'nairobi'
Restaurants in Nairobi|select c.city_name, r.rest_name, r.description, r.avg_price_usd from city c join restaurant r on c.city_id = r.city_id where c.city_name = 'nairobi'
Dishes in Nairobi|select f.dish_name, f.description, f.price_usd, r.rest_name, c.city_name from (city c join restaurant r on c.city_id = r.city_id) join food f on f.restaurant_id = r.rest_id where c.city_name = 'nairobi'
Museums in Kenya|select c.city_name, c.country, m.museum_name, m.type, m.description from city c join museum m on c.city_id = m.city_id where c.country = 'kenya'
Parks in Kenya|select c.city_name, c.country, p.park_name, p.type, p.description from city c join park p on c.city_id = p.city_id where c.country = 'kenya'
Famous Sightseeing in Kenya|select c.city_name, c.country, s.sight_name, s.description from city c join famous_sight s on c.city_id = s.city_id where c.country = 'kenya'
Restaurants in Kenya|select c.city_name, c.country, r.rest_name, r.description, r.avg_price_usd from city c join restaurant r on c.city_id = r.city_id where c.country = 'kenya'
Dishes in Kenya|select f.dish_name, f.description, f.price_usd, r.rest_name, c.city_name, c.country from (city c join restaurant r on c.city_id = r.city_id) join food f on f.restaurant_id = r.rest_id where c.country = 'kenya'
Museums in Kuwait City|select c.city_name, m.museum_name, m.type, m.description from city c join museum m on c.city_id = m.city_id where c.city_name = 'kuwait city'
Parks in Kuwait City|select c.city_name, p.park_name, p.type, p.description from city c join park p on c.city_id = p.city_id where c.city_name = 'kuwait city'
Famous Sightseeing in Kuwait City|select c.city_name, s.sight_name, s.description from city c join famous_sight s on c.city_id = s.city_id where c.city_name = 'kuwait city'
Restaurants in Kuwait City|select c.city_name, r.rest_name, r.description, r.avg_price_usd from city c join restaurant r on c.city_id = r.city_id where c.city_name = 'kuwait city'
Dishes in Kuwait City|select f.dish_name, f.description, f.price_usd, r.rest_name, c.city_name from (city c join restaurant r on c.city_id = r.city_id) join food f on f.restaurant_id = r.rest_id where c.city_name = 'kuwait city'
Museums in Kuwait|select c.city_name, c.country, m.museum_name, m.type, m.description from city c join museum m on c.city_id = m.city_id where c.country = 'kuwait'
Parks in Kuwait|select c.city_name, c.country, p.park_name, p.type, p.description from city c join park p on c.city_id = p.city_id where c.country = 'kuwait'
Famous Sightseeing in Kuwait|select c.city_name, c.country, s.sight_name, s.description from city c join famous_sight s on c.city_id = s.city_id where c.country = 'kuwait'
Restaurants in Kuwait|select c.city_name, c.country, r.rest_name, r.description, r.avg_price_usd from city c join restaurant r on c.city_id = r.city_id where c.country = 'kuwait'
Dishes in Kuwait|select f.dish_name, f.description, f.price_usd, r.rest_name, c.city_name, c.country from (city c join restaurant r on c.city_id = r.city_id) join food f on f.restaurant_id = r.rest_id where c.country = 'kuwait'
Museums in Mexico City|select c.city_name, m.museum_name, m.type, m.description from city c join museum m on c.city_id = m.city_id where c.city_name = 'mexico city'
Parks in Mexico City|select c.city_name, p.park_name, p.type, p.description from city c join park p on c.city_id = p.city_id where c.city_name = 'mexico city'
Famous Sightseeing in Mexico City|select c.city_name, s.sight_name, s.description from city c join famous_sight s on c.city_id = s.city_id where c.city_name = 'mexico city'
Restaurants in Mexico City|select c.city_name, r.rest_name, r.description, r.avg_price_usd from city c join restaurant r on c.city_id = r.city_id where c.city_name = 'mexico city'
Dishes in Mexico City|select f.dish_name, f.description, f.price_usd, r.rest_name, c.city_name from (city c join restaurant r on c.city_id = r.city_id) join food f on f.restaurant_id = r.rest_id where c.city_name = 'mexico city'
Museums in Mexico|select c.city_name, c.country, m.museum_name, m.type, m.description from city c join museum m on c.city_id = m.city_id where c.country = 'mexico'
Parks in Mexico|select c.city_name, c.country, p.park_name, p.type, p.description from city c join park p on c.city_id = p.city_id where c.country = 'mexico'
Famous Sightseeing in Mexico|select c.city_name, c.country, s.sight_name, s.description from city c join famous_sight s on c.city_id = s.city_id where c.country = 'mexico'
Restaurants in Mexico|select c.city_name, c.country, r.rest_name, r.description, r.avg_price_usd from city c join restaurant r on c.city_id = r.city_id where c.country = 'mexico'
Dishes in Mexico|select f.dish_name, f.description, f.price_usd, r.rest_name, c.city_name, c.country from (city c join restaurant r on c.city_id = r.city_id) join food f on f.restaurant_id = r.rest_id where c.country = 'mexico'
Museums in Casablanca|select c.city_name, m.museum_name, m.type, m.description from city c join museum m on c.city_id = m.city_id where c.city_name = 'casablanca'
Parks in Casablanca|select c.city_name, p.park_name, p.type, p.description from city c join park p on c.city_id = p.city_id where c.city_name = 'casablanca'
Famous Sightseeing in Casablanca|select c.city_name, s.sight_name, s.description from city c join famous_sight s on c.city_id = s.city_id where c.city_name = 'casablanca'
Restaurants in Casablanca|select c.city_name, r.rest_name, r.description, r.avg_price_usd from city c join restaurant r on c.city_id = r.city_id where c.city_name = 'casablanca'
Dishes in Casablanca|select f.dish_name, f.description, f.price_usd, r.rest_name, c.city_name from (city c join restaurant r on c.city_id = r.city_id) join food f on f.restaurant_id = r.rest_id where c.city_name = 'casablanca'
Museums in Morocco|select c.city_name, c.country, m.museum_name, m.type, m.description from city c join museum m on c.city_id = m.city_id where c.country = 'morocco'
Parks in Morocco|select c.city_name, c.country, p.park_name, p.type, p.description from city c join park p on c.city_id = p.city_id where c.country = 'morocco'
Famous Sightseeing in Morocco|select c.city_name, c.country, s.sight_name, s.description from city c join famous_sight s on c.city_id = s.city_id where c.country = 'morocco'
Restaurants in Morocco|select c.city_name, c.country, r.rest_name, r.description, r.avg_price_usd from city c join restaurant r on c.city_id = r.city_id where c.country = 'morocco'
Dishes in Morocco|select f.dish_name, f.description, f.price_usd, r.rest_name, c.city_name, c.country from (city c join restaurant r on c.city_id = r.city_id) join food f on f.restaurant_id = r.rest_id where c.country = 'morocco'
Museums in Kathmandu|select c.city_name, m.museum_name, m.type, m.description from city c join museum m on c.city_id = m.city_id where c.city_name = 'kathmandu'
Parks in Kathmandu|select c.city_name, p.park_name, p.type, p.description from city c join park p on c.city_id = p.city_id where c.city_name = 'kathmandu'
Famous Sightseeing in Kathmandu|select c.city_name, s.sight_name, s.description from city c join famous_sight s on c.city_id = s.city_id where c.city_name = 'kathmandu'
Restaurants in Kathmandu|select c.city_name, r.rest_name, r.description, r.avg_price_usd from city c join restaurant r on c.city_id = r.city_id where c.city_name = 'kathmandu'
Dishes in Kathmandu|select f.dish_name, f.description, f.price_usd, r.rest_name, c.city_name from (city c join restaurant r on c.city_id = r.city_id) join food f on f.restaurant_id = r.rest_id where c.city_name = 'kathmandu'
Museums in Nepal|select c.city_name, c.country, m.museum_name, m.type, m.description from city c join museum m on c.city_id = m.city_id where c.country = 'nepal'
Parks in Nepal|select c.city_name, c.country, p.park_name, p.type, p.description from city c join park p on c.city_id = p.city_id where c.country = 'nepal'
Famous Sightseeing in Nepal|select c.city_name, c.country, s.sight_name, s.description from city c join famous_sight s on c.city_id = s.city_id where c.country = 'nepal'
Restaurants in Nepal|select c.city_name, c.country, r.rest_name, r.description, r.avg_price_usd from city c join restaurant r on c.city_id = r.city_id where c.country = 'nepal'
Dishes in Nepal|select f.dish_name, f.description, f.price_usd, r.rest_name, c.city_name, c.country from (city c join restaurant r on c.city_id = r.city_id) join food f on f.restaurant_id = r.rest_id where c.country = 'nepal'
Museums in Amsterdam|select c.city_name, m.museum_name, m.type, m.description from city c join museum m on c.city_id = m.city_id where c.city_name = 'amsterdam'
Parks in Amsterdam|select c.city_name, p.park_name, p.type, p.description from city c join park p on c.city_id = p.city_id where c.city_name = 'amsterdam'
Famous Sightseeing in Amsterdam|select c.city_name, s.sight_name, s.description from city c join famous_sight s on c.city_id = s.city_id where c.city_name = 'amsterdam'
Restaurants in Amsterdam|select c.city_name, r.rest_name, r.description, r.avg_price_usd from city c join restaurant r on c.city_id = r.city_id where c.city_name = 'amsterdam'
Dishes in Amsterdam|select f.dish_name, f.description, f.price_usd, r.rest_name, c.city_name from (city c join restaurant r on c.city_id = r.city_id) join food f on f.restaurant_id = r.rest_id where c.city_name = 'amsterdam'
Museums in Netherlands|select c.city_name, c.country, m.museum_name, m.type, m.description from city c join museum m on c.city_id = m.city_id where c.country = 'netherlands'
Parks in Netherlands|select c.city_name, c.country, p.park_name, p.type, p.description from city c join park p on c.city_id = p.city_id where c.country = 'netherlands'
Famous Sightseeing in Netherlands|select c.city_name, c.country, s.sight_name, s.description from city c join famous_sight s on c.city_id = s.city_id where c.country = 'netherlands'
Restaurants in Netherlands|select c.city_name, c.country, r.rest_name, r.description, r.avg_price_usd from city c join restaurant r on c.city_id = r.city_id where c.country = 'netherlands'
Dishes in Netherlands|select f.dish_name, f.description, f.price_usd, r.rest_name, c.city_name, c.country from (city c join restaurant r on c.city_id = r.city_id) join food f on f.restaurant_id = r.rest_id where c.country = 'netherlands'
Museums in Kano|select c.city_name, m.museum_name, m.type, m.description from city c join museum m on c.city_id = m.city_id where c.city_name = 'kano'
Parks in Kano|select c.city_name, p.park_name, p.type, p.description from city c join park p on c.city_id = p.city_id where c.city_name = 'kano'
Famous Sightseeing in Kano|select c.city_name, s.sight_name, s.description from city c join famous_sight s on c.city_id = s.city_id where c.city_name = 'kano'
Restaurants in Kano|select c.city_name, r.rest_name, r.description, r.avg_price_usd from city c join restaurant r on c.city_id = r.city_id where c.city_name = 'kano'
Dishes in Kano|select f.dish_name, f.description, f.price_usd, r.rest_name, c.city_name from (city c join restaurant r on c.city_id = r.city_id) join food f on f.restaurant_id = r.rest_id where c.city_name = 'kano'
Museums in Nigeria|select c.city_name, c.country, m.museum_name, m.type, m.description from city c join museum m on c.city_id = m.city_id where c.country = 'nigeria'
Parks in Nigeria|select c.city_name, c.country, p.park_name, p.type, p.description from city c join park p on c.city_id = p.city_id where c.country = 'nigeria'
Famous Sightseeing in Nigeria|select c.city_name, c.country, s.sight_name, s.description from city c join famous_sight s on c.city_id = s.city_id where c.country = 'nigeria'
Restaurants in Nigeria|select c.city_name, c.country, r.rest_name, r.description, r.avg_price_usd from city c join restaurant r on c.city_id = r.city_id where c.country = 'nigeria'
Dishes in Nigeria|select f.dish_name, f.description, f.price_usd, r.rest_name, c.city_name, c.country from (city c join restaurant r on c.city_id = r.city_id) join food f on f.restaurant_id = r.rest_id where c.country = 'nigeria'
Museums in Pyongyang|select c.city_name, m.museum_name, m.type, m.description from city c join museum m on c.city_id = m.city_id where c.city_name = 'pyongyang'
Parks in Pyongyang|select c.city_name, p.park_name, p.type, p.description from city c join park p on c.city_id = p.city_id where c.city_name = 'pyongyang'
Famous Sightseeing in Pyongyang|select c.city_name, s.sight_name, s.description from city c join famous_sight s on c.city_id = s.city_id where c.city_name = 'pyongyang'
Restaurants in Pyongyang|select c.city_name, r.rest_name, r.description, r.avg_price_usd from city c join restaurant r on c.city_id = r.city_id where c.city_name = 'pyongyang'
Dishes in Pyongyang|select f.dish_name, f.description, f.price_usd, r.rest_name, c.city_name from (city c join restaurant r on c.city_id = r.city_id) join food f on f.restaurant_id = r.rest_id where c.city_name = 'pyongyang'
Museums in North Korea|select c.city_name, c.country, m.museum_name, m.type, m.description from city c join museum m on c.city_id = m.city_id where c.country = 'north korea'
Parks in North Korea|select c.city_name, c.country, p.park_name, p.type, p.description from city c join park p on c.city_id = p.city_id where c.country = 'north korea'
Famous Sightseeing in North Korea|select c.city_name, c.country, s.sight_name, s.description from city c join famous_sight s on c.city_id = s.city_id where c.country = 'north korea'
Restaurants in North Korea|select c.city_name, c.country, r.rest_name, r.description, r.avg_price_usd from city c join restaurant r on c.city_id = r.city_id where c.country = 'north korea'
Dishes in North Korea|select f.dish_name, f.description, f.price_usd, r.rest_name, c.city_name, c.country from (city c join restaurant r on c.city_id = r.city_id) join food f on f.restaurant_id = r.rest_id where c.country = 'north korea'
Museums in Karachi|select c.city_name, m.museum_name, m.type, m.description from city c join museum m on c.city_id = m.city_id where c.city_name = 'karachi'
Parks in Karachi|select c.city_name, p.park_name, p.type, p.description from city c join park p on c.city_id = p.city_id where c.city_name = 'karachi'
Famous Sightseeing in Karachi|select c.city_name, s.sight_name, s.description from city c join famous_sight s on c.city_id = s.city_id where c.city_name = 'karachi'
Restaurants in Karachi|select c.city_name, r.rest_name, r.description, r.avg_price_usd from city c join restaurant r on c.city_id = r.city_id where c.city_name = 'karachi'
Dishes in Karachi|select f.dish_name, f.description, f.price_usd, r.rest_name, c.city_name from (city c join restaurant r on c.city_id = r.city_id) join food f on f.restaurant_id = r.rest_id where c.city_name = 'karachi'
Museums in Pakistan|select c.city_name, c.country, m.museum_name, m.type, m.description from city c join museum m on c.city_id = m.city_id where c.country = 'pakistan'
Parks in Pakistan|select c.city_name, c.country, p.park_name, p.type, p.description from city c join park p on c.city_id = p.city_id where c.country = 'pakistan'
Famous Sightseeing in Pakistan|select c.city_name, c.country, s.sight_name, s.description from city c join famous_sight s on c.city_id = s.city_id where c.country = 'pakistan'
Restaurants in Pakistan|select c.city_name, c.country, r.rest_name, r.description, r.avg_price_usd from city c join restaurant r on c.city_id = r.city_id where c.country = 'pakistan'
Dishes in Pakistan|select f.dish_name, f.description, f.price_usd, r.rest_name, c.city_name, c.country from (city c join restaurant r on c.city_id = r.city_id) join food f on f.restaurant_id = r.rest_id where c.country = 'pakistan'
Museums in Lahore|select c.city_name, m.museum_name, m.type, m.description from city c join museum m on c.city_id = m.city_id where c.city_name = 'lahore'
Parks in Lahore|select c.city_name, p.park_name, p.type, p.description from city c join park p on c.city_id = p.city_id where c.city_name = 'lahore'
Famous Sightseeing in Lahore|select c.city_name, s.sight_name, s.description from city c join famous_sight s on c.city_id = s.city_id where c.city_name = 'lahore'
Restaurants in Lahore|select c.city_name, r.rest_name, r.description, r.avg_price_usd from city c join restaurant r on c.city_id = r.city_id where c.city_name = 'lahore'
Dishes in Lahore|select f.dish_name, f.description, f.price_usd, r.rest_name, c.city_name from (city c join restaurant r on c.city_id = r.city_id) join food f on f.restaurant_id = r.rest_id where c.city_name = 'lahore'
Museums in Faisalabad|select c.city_name, m.museum_name, m.type, m.description from city c join museum m on c.city_id = m.city_id where c.city_name = 'faisalabad'
Parks in Faisalabad|select c.city_name, p.park_name, p.type, p.description from city c join park p on c.city_id = p.city_id where c.city_name = 'faisalabad'
Famous Sightseeing in Faisalabad|select c.city_name, s.sight_name, s.description from city c join famous_sight s on c.city_id = s.city_id where c.city_name = 'faisalabad'
Restaurants in Faisalabad|select c.city_name, r.rest_name, r.description, r.avg_price_usd from city c join restaurant r on c.city_id = r.city_id where c.city_name = 'faisalabad'
Dishes in Faisalabad|select f.dish_name, f.description, f.price_usd, r.rest_name, c.city_name from (city c join restaurant r on c.city_id = r.city_id) join food f on f.restaurant_id = r.rest_id where c.city_name = 'faisalabad'
Museums in Peshawar|select c.city_name, m.museum_name, m.type, m.description from city c join museum m on c.city_id = m.city_id where c.city_name = 'peshawar'
Parks in Peshawar|select c.city_name, p.park_name, p.type, p.description from city c join park p on c.city_id = p.city_id where c.city_name = 'peshawar'
Famous Sightseeing in Peshawar|select c.city_name, s.sight_name, s.description from city c join famous_sight s on c.city_id = s.city_id where c.city_name = 'peshawar'
Restaurants in Peshawar|select c.city_name, r.rest_name, r.description, r.avg_price_usd from city c join restaurant r on c.city_id = r.city_id where c.city_name = 'peshawar'
Dishes in Peshawar|select f.dish_name, f.description, f.price_usd, r.rest_name, c.city_name from (city c join restaurant r on c.city_id = r.city_id) join food f on f.restaurant_id = r.rest_id where c.city_name = 'peshawar'
Museums in Asuncion|select c.city_name, m.museum_name, m.type, m.description from city c join museum m on c.city_id = m.city_id where c.city_name = 'asuncion'
Parks in Asuncion|select c.city_name, p.park_name, p.type, p.description from city c join park p on c.city_id = p.city_id where c.city_name = 'asuncion'
Famous Sightseeing in Asuncion|select c.city_name, s.sight_name, s.description from city c join famous_sight s on c.city_id = s.city_id where c.city_name = 'asuncion'
Restaurants in Asuncion|select c.city_name, r.rest_name, r.description, r.avg_price_usd from city c join restaurant r on c.city_id = r.city_id where c.city_name = 'asuncion'
Dishes in Asuncion|select f.dish_name, f.description, f.price_usd, r.rest_name, c.city_name from (city c join restaurant r on c.city_id = r.city_id) join food f on f.restaurant_id = r.rest_id where c.city_name = 'asuncion'
Museums in Paraguay|select c.city_name, c.country, m.museum_name, m.type, m.description from city c join museum m on c.city_id = m.city_id where c.country = 'paraguay'
Parks in Paraguay|select c.city_name, c.country, p.park_name, p.type, p.description from city c join park p on c.city_id = p.city_id where c.country = 'paraguay'
Famous Sightseeing in Paraguay|select c.city_name, c.country, s.sight_name, s.description from city c join famous_sight s on c.city_id = s.city_id where c.country = 'paraguay'
Restaurants in Paraguay|select c.city_name, c.country, r.rest_name, r.description, r.avg_price_usd from city c join restaurant r on c.city_id = r.city_id where c.country = 'paraguay'
Dishes in Paraguay|select f.dish_name, f.description, f.price_usd, r.rest_name, c.city_name, c.country from (city c join restaurant r on c.city_id = r.city_id) join food f on f.restaurant_id = r.rest_id where c.country = 'paraguay'
Museums in Lima|select c.city_name, m.museum_name, m.type, m.description from city c join museum m on c.city_id = m.city_id where c.city_name = 'lima'
Parks in Lima|select c.city_name, p.park_name, p.type, p.description from city c join park p on c.city_id = p.city_id where c.city_name = 'lima'
Famous Sightseeing in Lima|select c.city_name, s.sight_name, s.description from city c join famous_sight s on c.city_id = s.city_id where c.city_name = 'lima'
Restaurants in Lima|select c.city_name, r.rest_name, r.description, r.avg_price_usd from city c join restaurant r on c.city_id = r.city_id where c.city_name = 'lima'
Dishes in Lima|select f.dish_name, f.description, f.price_usd, r.rest_name, c.city_name from (city c join restaurant r on c.city_id = r.city_id) join food f on f.restaurant_id = r.rest_id where c.city_name = 'lima'
Museums in Peru|select c.city_name, c.country, m.museum_name, m.type, m.description from city c join museum m on c.city_id = m.city_id where c.country = 'peru'
Parks in Peru|select c.city_name, c.country, p.park_name, p.type, p.description from city c join park p on c.city_id = p.city_id where c.country = 'peru'
Famous Sightseeing in Peru|select c.city_name, c.country, s.sight_name, s.description from city c join famous_sight s on c.city_id = s.city_id where c.country = 'peru'
Restaurants in Peru|select c.city_name, c.country, r.rest_name, r.description, r.avg_price_usd from city c join restaurant r on c.city_id = r.city_id where c.country = 'peru'
Dishes in Peru|select f.dish_name, f.description, f.price_usd, r.rest_name, c.city_name, c.country from (city c join restaurant r on c.city_id = r.city_id) join food f on f.restaurant_id = r.rest_id where c.country = 'peru'
Museums in Manila|select c.city_name, m.museum_name, m.type, m.description from city c join museum m on c.city_id = m.city_id where c.city_name = 'manila'
Parks in Manila|select c.city_name, p.park_name, p.type, p.description from city c join park p on c.city_id = p.city_id where c.city_name = 'manila'
Famous Sightseeing in Manila|select c.city_name, s.sight_name, s.description from city c join famous_sight s on c.city_id = s.city_id where c.city_name = 'manila'
Restaurants in Manila|select c.city_name, r.rest_name, r.description, r.avg_price_usd from city c join restaurant r on c.city_id = r.city_id where c.city_name = 'manila'
Dishes in Manila|select f.dish_name, f.description, f.price_usd, r.rest_name, c.city_name from (city c join restaurant r on c.city_id = r.city_id) join food f on f.restaurant_id = r.rest_id where c.city_name = 'manila'
Museums in Philippines|select c.city_name, c.country, m.museum_name, m.type, m.description from city c join museum m on c.city_id = m.city_id where c.country = 'philippines'
Parks in Philippines|select c.city_name, c.country, p.park_name, p.type, p.description from city c join park p on c.city_id = p.city_id where c.country = 'philippines'
Famous Sightseeing in Philippines|select c.city_name, c.country, s.sight_name, s.description from city c join famous_sight s on c.city_id = s.city_id where c.country = 'philippines'
Restaurants in Philippines|select c.city_name, c.country, r.rest_name, r.description, r.avg_price_usd from city c join restaurant r on c.city_id = r.city_id where c.country = 'philippines'
Dishes in Philippines|select f.dish_name, f.description, f.price_usd, r.rest_name, c.city_name, c.country from (city c join restaurant r on c.city_id = r.city_id) join food f on f.restaurant_id = r.rest_id where c.country = 'philippines'
Museums in Lisbon|select c.city_name, m.museum_name, m.type, m.description from city c join museum m on c.city_id = m.city_id where c.city_name = 'lisbon'
Parks in Lisbon|select c.city_name, p.park_name, p.type, p.description from city c join park p on c.city_id = p.city_id where c.city_name = 'lisbon'
Famous Sightseeing in Lisbon|select c.city_name, s.sight_name, s.description from city c join famous_sight s on c.city_id = s.city_id where c.city_name = 'lisbon'
Restaurants in Lisbon|select c.city_name, r.rest_name, r.description, r.avg_price_usd from city c join restaurant r on c.city_id = r.city_id where c.city_name = 'lisbon'
Dishes in Lisbon|select f.dish_name, f.description, f.price_usd, r.rest_name, c.city_name from (city c join restaurant r on c.city_id = r.city_id) join food f on f.restaurant_id = r.rest_id where c.city_name = 'lisbon'
Museums in Portugal|select c.city_name, c.country, m.museum_name, m.type, m.description from city c join museum m on c.city_id = m.city_id where c.country = 'portugal'
Parks in Portugal|select c.city_name, c.country, p.park_name, p.type, p.description from city c join park p on c.city_id = p.city_id where c.country = 'portugal'
Famous Sightseeing in Portugal|select c.city_name, c.country, s.sight_name, s.description from city c join famous_sight s on c.city_id = s.city_id where c.country = 'portugal'
Restaurants in Portugal|select c.city_name, c.country, r.rest_name, r.description, r.avg_price_usd from city c join restaurant r on c.city_id = r.city_id where c.country = 'portugal'
Dishes in Portugal|select f.dish_name, f.description, f.price_usd, r.rest_name, c.city_name, c.country from (city c join restaurant r on c.city_id = r.city_id) join food f on f.restaurant_id = r.rest_id where c.country = 'portugal'
Museums in San Juan|select c.city_name, m.museum_name, m.type, m.description from city c join museum m on c.city_id = m.city_id where c.city_name = 'san juan'
Parks in San Juan|select c.city_name, p.park_name, p.type, p.description from city c join park p on c.city_id = p.city_id where c.city_name = 'san juan'
Famous Sightseeing in San Juan|select c.city_name, s.sight_name, s.description from city c join famous_sight s on c.city_id = s.city_id where c.city_name = 'san juan'
Restaurants in San Juan|select c.city_name, r.rest_name, r.description, r.avg_price_usd from city c join restaurant r on c.city_id = r.city_id where c.city_name = 'san juan'
Dishes in San Juan|select f.dish_name, f.description, f.price_usd, r.rest_name, c.city_name from (city c join restaurant r on c.city_id = r.city_id) join food f on f.restaurant_id = r.rest_id where c.city_name = 'san juan'
Museums in Puerto Rico|select c.city_name, c.country, m.museum_name, m.type, m.description from city c join museum m on c.city_id = m.city_id where c.country = 'puerto rico'
Parks in Puerto Rico|select c.city_name, c.country, p.park_name, p.type, p.description from city c join park p on c.city_id = p.city_id where c.country = 'puerto rico'
Famous Sightseeing in Puerto Rico|select c.city_name, c.country, s.sight_name, s.description from city c join famous_sight s on c.city_id = s.city_id where c.country = 'puerto rico'
Restaurants in Puerto Rico|select c.city_name, c.country, r.rest_name, r.description, r.avg_price_usd from city c join restaurant r on c.city_id = r.city_id where c.country = 'puerto rico'
Dishes in Puerto Rico|select f.dish_name, f.description, f.price_usd, r.rest_name, c.city_name, c.country from (city c join restaurant r on c.city_id = r.city_id) join food f on f.restaurant_id = r.rest_id where c.country = 'puerto rico'
Museums in Moscow|select c.city_name, m.museum_name, m.type, m.description from city c join museum m on c.city_id = m.city_id where c.city_name = 'moscow'
Parks in Moscow|select c.city_name, p.park_name, p.type, p.description from city c join park p on c.city_id = p.city_id where c.city_name = 'moscow'
Famous Sightseeing in Moscow|select c.city_name, s.sight_name, s.description from city c join famous_sight s on c.city_id = s.city_id where c.city_name = 'moscow'
Restaurants in Moscow|select c.city_name, r.rest_name, r.description, r.avg_price_usd from city c join restaurant r on c.city_id = r.city_id where c.city_name = 'moscow'
Dishes in Moscow|select f.dish_name, f.description, f.price_usd, r.rest_name, c.city_name from (city c join restaurant r on c.city_id = r.city_id) join food f on f.restaurant_id = r.rest_id where c.city_name = 'moscow'
Museums in Russia|select c.city_name, c.country, m.museum_name, m.type, m.description from city c join museum m on c.city_id = m.city_id where c.country = 'russia'
Parks in Russia|select c.city_name, c.country, p.park_name, p.type, p.description from city c join park p on c.city_id = p.city_id where c.country = 'russia'
Famous Sightseeing in Russia|select c.city_name, c.country, s.sight_name, s.description from city c join famous_sight s on c.city_id = s.city_id where c.country = 'russia'
Restaurants in Russia|select c.city_name, c.country, r.rest_name, r.description, r.avg_price_usd from city c join restaurant r on c.city_id = r.city_id where c.country = 'russia'
Dishes in Russia|select f.dish_name, f.description, f.price_usd, r.rest_name, c.city_name, c.country from (city c join restaurant r on c.city_id = r.city_id) join food f on f.restaurant_id = r.rest_id where c.country = 'russia'
Museums in Saint Petersburg|select c.city_name, m.museum_name, m.type, m.description from city c join museum m on c.city_id = m.city_id where c.city_name = 'saint petersburg'
Parks in Saint Petersburg|select c.city_name, p.park_name, p.type, p.description from city c join park p on c.city_id = p.city_id where c.city_name = 'saint petersburg'
Famous Sightseeing in Saint Petersburg|select c.city_name, s.sight_name, s.description from city c join famous_sight s on c.city_id = s.city_id where c.city_name = 'saint petersburg'
Restaurants in Saint Petersburg|select c.city_name, r.rest_name, r.description, r.avg_price_usd from city c join restaurant r on c.city_id = r.city_id where c.city_name = 'saint petersburg'
Dishes in Saint Petersburg|select f.dish_name, f.description, f.price_usd, r.rest_name, c.city_name from (city c join restaurant r on c.city_id = r.city_id) join food f on f.restaurant_id = r.rest_id where c.city_name = 'saint petersburg'
Museums in Ekaterinburg|select c.city_name, m.museum_name, m.type, m.description from city c join museum m on c.city_id = m.city_id where c.city_name = 'ekaterinburg'
Parks in Ekaterinburg|select c.city_name, p.park_name, p.type, p.description from city c join park p on c.city_id = p.city_id where c.city_name = 'ekaterinburg'
Famous Sightseeing in Ekaterinburg|select c.city_name, s.sight_name, s.description from city c join famous_sight s on c.city_id = s.city_id where c.city_name = 'ekaterinburg'
Restaurants in Ekaterinburg|select c.city_name, r.rest_name, r.description, r.avg_price_usd from city c join restaurant r on c.city_id = r.city_id where c.city_name = 'ekaterinburg'
Dishes in Ekaterinburg|select f.dish_name, f.description, f.price_usd, r.rest_name, c.city_name from (city c join restaurant r on c.city_id = r.city_id) join food f on f.restaurant_id = r.rest_id where c.city_name = 'ekaterinburg'
Museums in Riyadh|select c.city_name, m.museum_name, m.type, m.description from city c join museum m on c.city_id = m.city_id where c.city_name = 'riyadh'
Parks in Riyadh|select c.city_name, p.park_name, p.type, p.description from city c join park p on c.city_id = p.city_id where c.city_name = 'riyadh'
Famous Sightseeing in Riyadh|select c.city_name, s.sight_name, s.description from city c join famous_sight s on c.city_id = s.city_id where c.city_name = 'riyadh'
Restaurants in Riyadh|select c.city_name, r.rest_name, r.description, r.avg_price_usd from city c join restaurant r on c.city_id = r.city_id where c.city_name = 'riyadh'
Dishes in Riyadh|select f.dish_name, f.description, f.price_usd, r.rest_name, c.city_name from (city c join restaurant r on c.city_id = r.city_id) join food f on f.restaurant_id = r.rest_id where c.city_name = 'riyadh'
Museums in Saudi Arabia|select c.city_name, c.country, m.museum_name, m.type, m.description from city c join museum m on c.city_id = m.city_id where c.country = 'saudi arabia'
Parks in Saudi Arabia|select c.city_name, c.country, p.park_name, p.type, p.description from city c join park p on c.city_id = p.city_id where c.country = 'saudi arabia'
Famous Sightseeing in Saudi Arabia|select c.city_name, c.country, s.sight_name, s.description from city c join famous_sight s on c.city_id = s.city_id where c.country = 'saudi arabia'
Restaurants in Saudi Arabia|select c.city_name, c.country, r.rest_name, r.description, r.avg_price_usd from city c join restaurant r on c.city_id = r.city_id where c.country = 'saudi arabia'
Dishes in Saudi Arabia|select f.dish_name, f.description, f.price_usd, r.rest_name, c.city_name, c.country from (city c join restaurant r on c.city_id = r.city_id) join food f on f.restaurant_id = r.rest_id where c.country = 'saudi arabia'
Museums in Jeddah|select c.city_name, m.museum_name, m.type, m.description from city c join museum m on c.city_id = m.city_id where c.city_name = 'jeddah'
Parks in Jeddah|select c.city_name, p.park_name, p.type, p.description from city c join park p on c.city_id = p.city_id where c.city_name = 'jeddah'
Famous Sightseeing in Jeddah|select c.city_name, s.sight_name, s.description from city c join famous_sight s on c.city_id = s.city_id where c.city_name = 'jeddah'
Restaurants in Jeddah|select c.city_name, r.rest_name, r.description, r.avg_price_usd from city c join restaurant r on c.city_id = r.city_id where c.city_name = 'jeddah'
Dishes in Jeddah|select f.dish_name, f.description, f.price_usd, r.rest_name, c.city_name from (city c join restaurant r on c.city_id = r.city_id) join food f on f.restaurant_id = r.rest_id where c.city_name = 'jeddah'
Museums in Singapore|select c.city_name, m.museum_name, m.type, m.description from city c join museum m on c.city_id = m.city_id where c.city_name = 'singapore'
Parks in Singapore|select c.city_name, p.park_name, p.type, p.description from city c join park p on c.city_id = p.city_id where c.city_name = 'singapore'
Famous Sightseeing in Singapore|select c.city_name, s.sight_name, s.description from city c join famous_sight s on c.city_id = s.city_id where c.city_name = 'singapore'
Restaurants in Singapore|select c.city_name, r.rest_name, r.description, r.avg_price_usd from city c join restaurant r on c.city_id = r.city_id where c.city_name = 'singapore'
Dishes in Singapore|select f.dish_name, f.description, f.price_usd, r.rest_name, c.city_name from (city c join restaurant r on c.city_id = r.city_id) join food f on f.restaurant_id = r.rest_id where c.city_name = 'singapore'
Museums in Singapore|select c.city_name, c.country, m.museum_name, m.type, m.description from city c join museum m on c.city_id = m.city_id where c.country = 'singapore'
Parks in Singapore|select c.city_name, c.country, p.park_name, p.type, p.description from city c join park p on c.city_id = p.city_id where c.country = 'singapore'
Famous Sightseeing in Singapore|select c.city_name, c.country, s.sight_name, s.description from city c join famous_sight s on c.city_id = s.city_id where c.country = 'singapore'
Restaurants in Singapore|select c.city_name, c.country, r.rest_name, r.description, r.avg_price_usd from city c join restaurant r on c.city_id = r.city_id where c.country = 'singapore'
Dishes in Singapore|select f.dish_name, f.description, f.price_usd, r.rest_name, c.city_name, c.country from (city c join restaurant r on c.city_id = r.city_id) join food f on f.restaurant_id = r.rest_id where c.country = 'singapore'
Museums in Johannesburg|select c.city_name, m.museum_name, m.type, m.description from city c join museum m on c.city_id = m.city_id where c.city_name = 'johannesburg'
Parks in Johannesburg|select c.city_name, p.park_name, p.type, p.description from city c join park p on c.city_id = p.city_id where c.city_name = 'johannesburg'
Famous Sightseeing in Johannesburg|select c.city_name, s.sight_name, s.description from city c join famous_sight s on c.city_id = s.city_id where c.city_name = 'johannesburg'
Restaurants in Johannesburg|select c.city_name, r.rest_name, r.description, r.avg_price_usd from city c join restaurant r on c.city_id = r.city_id where c.city_name = 'johannesburg'
Dishes in Johannesburg|select f.dish_name, f.description, f.price_usd, r.rest_name, c.city_name from (city c join restaurant r on c.city_id = r.city_id) join food f on f.restaurant_id = r.rest_id where c.city_name = 'johannesburg'
Museums in South Africa|select c.city_name, c.country, m.museum_name, m.type, m.description from city c join museum m on c.city_id = m.city_id where c.country = 'south africa'
Parks in South Africa|select c.city_name, c.country, p.park_name, p.type, p.description from city c join park p on c.city_id = p.city_id where c.country = 'south africa'
Famous Sightseeing in South Africa|select c.city_name, c.country, s.sight_name, s.description from city c join famous_sight s on c.city_id = s.city_id where c.country = 'south africa'
Restaurants in South Africa|select c.city_name, c.country, r.rest_name, r.description, r.avg_price_usd from city c join restaurant r on c.city_id = r.city_id where c.country = 'south africa'
Dishes in South Africa|select f.dish_name, f.description, f.price_usd, r.rest_name, c.city_name, c.country from (city c join restaurant r on c.city_id = r.city_id) join food f on f.restaurant_id = r.rest_id where c.country = 'south africa'
Museums in Cape Town|select c.city_name, m.museum_name, m.type, m.description from city c join museum m on c.city_id = m.city_id where c.city_name = 'cape town'
Parks in Cape Town|select c.city_name, p.park_name, p.type, p.description from city c join park p on c.city_id = p.city_id where c.city_name = 'cape town'
Famous Sightseeing in Cape Town|select c.city_name, s.sight_name, s.description from city c join famous_sight s on c.city_id = s.city_id where c.city_name = 'cape town'
Restaurants in Cape Town|select c.city_name, r.rest_name, r.description, r.avg_price_usd from city c join restaurant r on c.city_id = r.city_id where c.city_name = 'cape town'
Dishes in Cape Town|select f.dish_name, f.description, f.price_usd, r.rest_name, c.city_name from (city c join restaurant r on c.city_id = r.city_id) join food f on f.restaurant_id = r.rest_id where c.city_name = 'cape town'
Museums in Seoul|select c.city_name, m.museum_name, m.type, m.description from city c join museum m on c.city_id = m.city_id where c.city_name = 'seoul'
Parks in Seoul|select c.city_name, p.park_name, p.type, p.description from city c join park p on c.city_id = p.city_id where c.city_name = 'seoul'
Famous Sightseeing in Seoul|select c.city_name, s.sight_name, s.description from city c join famous_sight s on c.city_id = s.city_id where c.city_name = 'seoul'
Restaurants in Seoul|select c.city_name, r.rest_name, r.description, r.avg_price_usd from city c join restaurant r on c.city_id = r.city_id where c.city_name = 'seoul'
Dishes in Seoul|select f.dish_name, f.description, f.price_usd, r.rest_name, c.city_name from (city c join restaurant r on c.city_id = r.city_id) join food f on f.restaurant_id = r.rest_id where c.city_name = 'seoul'
Museums in South Korea|select c.city_name, c.country, m.museum_name, m.type, m.description from city c join museum m on c.city_id = m.city_id where c.country = 'south korea'
Parks in South Korea|select c.city_name, c.country, p.park_name, p.type, p.description from city c join park p on c.city_id = p.city_id where c.country = 'south korea'
Famous Sightseeing in South Korea|select c.city_name, c.country, s.sight_name, s.description from city c join famous_sight s on c.city_id = s.city_id where c.country = 'south korea'
Restaurants in South Korea|select c.city_name, c.country, r.rest_name, r.description, r.avg_price_usd from city c join restaurant r on c.city_id = r.city_id where c.country = 'south korea'
Dishes in South Korea|select f.dish_name, f.description, f.price_usd, r.rest_name, c.city_name, c.country from (city c join restaurant r on c.city_id = r.city_id) join food f on f.restaurant_id = r.rest_id where c.country = 'south korea'
Museums in Daejeon|select c.city_name, m.museum_name, m.type, m.description from city c join museum m on c.city_id = m.city_id where c.city_name = 'daejeon'
Parks in Daejeon|select c.city_name, p.park_name, p.type, p.description from city c join park p on c.city_id = p.city_id where c.city_name = 'daejeon'
Famous Sightseeing in Daejeon|select c.city_name, s.sight_name, s.description from city c join famous_sight s on c.city_id = s.city_id where c.city_name = 'daejeon'
Restaurants in Daejeon|select c.city_name, r.rest_name, r.description, r.avg_price_usd from city c join restaurant r on c.city_id = r.city_id where c.city_name = 'daejeon'
Dishes in Daejeon|select f.dish_name, f.description, f.price_usd, r.rest_name, c.city_name from (city c join restaurant r on c.city_id = r.city_id) join food f on f.restaurant_id = r.rest_id where c.city_name = 'daejeon'
Museums in Daegu|select c.city_name, m.museum_name, m.type, m.description from city c join museum m on c.city_id = m.city_id where c.city_name = 'daegu'
Parks in Daegu|select c.city_name, p.park_name, p.type, p.description from city c join park p on c.city_id = p.city_id where c.city_name = 'daegu'
Famous Sightseeing in Daegu|select c.city_name, s.sight_name, s.description from city c join famous_sight s on c.city_id = s.city_id where c.city_name = 'daegu'
Restaurants in Daegu|select c.city_name, r.rest_name, r.description, r.avg_price_usd from city c join restaurant r on c.city_id = r.city_id where c.city_name = 'daegu'
Dishes in Daegu|select f.dish_name, f.description, f.price_usd, r.rest_name, c.city_name from (city c join restaurant r on c.city_id = r.city_id) join food f on f.restaurant_id = r.rest_id where c.city_name = 'daegu'
Museums in Barcelona|select c.city_name, m.museum_name, m.type, m.description from city c join museum m on c.city_id = m.city_id where c.city_name = 'barcelona'
Parks in Barcelona|select c.city_name, p.park_name, p.type, p.description from city c join park p on c.city_id = p.city_id where c.city_name = 'barcelona'
Famous Sightseeing in Barcelona|select c.city_name, s.sight_name, s.description from city c join famous_sight s on c.city_id = s.city_id where c.city_name = 'barcelona'
Restaurants in Barcelona|select c.city_name, r.rest_name, r.description, r.avg_price_usd from city c join restaurant r on c.city_id = r.city_id where c.city_name = 'barcelona'
Dishes in Barcelona|select f.dish_name, f.description, f.price_usd, r.rest_name, c.city_name from (city c join restaurant r on c.city_id = r.city_id) join food f on f.restaurant_id = r.rest_id where c.city_name = 'barcelona'
Museums in Spain|select c.city_name, c.country, m.museum_name, m.type, m.description from city c join museum m on c.city_id = m.city_id where c.country = 'spain'
Parks in Spain|select c.city_name, c.country, p.park_name, p.type, p.description from city c join park p on c.city_id = p.city_id where c.country = 'spain'
Famous Sightseeing in Spain|select c.city_name, c.country, s.sight_name, s.description from city c join famous_sight s on c.city_id = s.city_id where c.country = 'spain'
Restaurants in Spain|select c.city_name, c.country, r.rest_name, r.description, r.avg_price_usd from city c join restaurant r on c.city_id = r.city_id where c.country = 'spain'
Dishes in Spain|select f.dish_name, f.description, f.price_usd, r.rest_name, c.city_name, c.country from (city c join restaurant r on c.city_id = r.city_id) join food f on f.restaurant_id = r.rest_id where c.country = 'spain'
Museums in Madrid|select c.city_name, m.museum_name, m.type, m.description from city c join museum m on c.city_id = m.city_id where c.city_name = 'madrid'
Parks in Madrid|select c.city_name, p.park_name, p.type, p.description from city c join park p on c.city_id = p.city_id where c.city_name = 'madrid'
Famous Sightseeing in Madrid|select c.city_name, s.sight_name, s.description from city c join famous_sight s on c.city_id = s.city_id where c.city_name = 'madrid'
Restaurants in Madrid|select c.city_name, r.rest_name, r.description, r.avg_price_usd from city c join restaurant r on c.city_id = r.city_id where c.city_name = 'madrid'
Dishes in Madrid|select f.dish_name, f.description, f.price_usd, r.rest_name, c.city_name from (city c join restaurant r on c.city_id = r.city_id) join food f on f.restaurant_id = r.rest_id where c.city_name = 'madrid'
Museums in Khartoum|select c.city_name, m.museum_name, m.type, m.description from city c join museum m on c.city_id = m.city_id where c.city_name = 'khartoum'
Parks in Khartoum|select c.city_name, p.park_name, p.type, p.description from city c join park p on c.city_id = p.city_id where c.city_name = 'khartoum'
Famous Sightseeing in Khartoum|select c.city_name, s.sight_name, s.description from city c join famous_sight s on c.city_id = s.city_id where c.city_name = 'khartoum'
Restaurants in Khartoum|select c.city_name, r.rest_name, r.description, r.avg_price_usd from city c join restaurant r on c.city_id = r.city_id where c.city_name = 'khartoum'
Dishes in Khartoum|select f.dish_name, f.description, f.price_usd, r.rest_name, c.city_name from (city c join restaurant r on c.city_id = r.city_id) join food f on f.restaurant_id = r.rest_id where c.city_name = 'khartoum'
Museums in Sudan|select c.city_name, c.country, m.museum_name, m.type, m.description from city c join museum m on c.city_id = m.city_id where c.country = 'sudan'
Parks in Sudan|select c.city_name, c.country, p.park_name, p.type, p.description from city c join park p on c.city_id = p.city_id where c.country = 'sudan'
Famous Sightseeing in Sudan|select c.city_name, c.country, s.sight_name, s.description from city c join famous_sight s on c.city_id = s.city_id where c.country = 'sudan'
Restaurants in Sudan|select c.city_name, c.country, r.rest_name, r.description, r.avg_price_usd from city c join restaurant r on c.city_id = r.city_id where c.country = 'sudan'
Dishes in Sudan|select f.dish_name, f.description, f.price_usd, r.rest_name, c.city_name, c.country from (city c join restaurant r on c.city_id = r.city_id) join food f on f.restaurant_id = r.rest_id where c.country = 'sudan'
Museums in Homs|select c.city_name, m.museum_name, m.type, m.description from city c join museum m on c.city_id = m.city_id where c.city_name = 'homs'
Parks in Homs|select c.city_name, p.park_name, p.type, p.description from city c join park p on c.city_id = p.city_id where c.city_name = 'homs'
Famous Sightseeing in Homs|select c.city_name, s.sight_name, s.description from city c join famous_sight s on c.city_id = s.city_id where c.city_name = 'homs'
Restaurants in Homs|select c.city_name, r.rest_name, r.description, r.avg_price_usd from city c join restaurant r on c.city_id = r.city_id where c.city_name = 'homs'
Dishes in Homs|select f.dish_name, f.description, f.price_usd, r.rest_name, c.city_name from (city c join restaurant r on c.city_id = r.city_id) join food f on f.restaurant_id = r.rest_id where c.city_name = 'homs'
Museums in Syria|select c.city_name, c.country, m.museum_name, m.type, m.description from city c join museum m on c.city_id = m.city_id where c.country = 'syria'
Parks in Syria|select c.city_name, c.country, p.park_name, p.type, p.description from city c join park p on c.city_id = p.city_id where c.country = 'syria'
Famous Sightseeing in Syria|select c.city_name, c.country, s.sight_name, s.description from city c join famous_sight s on c.city_id = s.city_id where c.country = 'syria'
Restaurants in Syria|select c.city_name, c.country, r.rest_name, r.description, r.avg_price_usd from city c join restaurant r on c.city_id = r.city_id where c.country = 'syria'
Dishes in Syria|select f.dish_name, f.description, f.price_usd, r.rest_name, c.city_name, c.country from (city c join restaurant r on c.city_id = r.city_id) join food f on f.restaurant_id = r.rest_id where c.country = 'syria'
Museums in Taipei|select c.city_name, m.museum_name, m.type, m.description from city c join museum m on c.city_id = m.city_id where c.city_name = 'taipei'
Parks in Taipei|select c.city_name, p.park_name, p.type, p.description from city c join park p on c.city_id = p.city_id where c.city_name = 'taipei'
Famous Sightseeing in Taipei|select c.city_name, s.sight_name, s.description from city c join famous_sight s on c.city_id = s.city_id where c.city_name = 'taipei'
Restaurants in Taipei|select c.city_name, r.rest_name, r.description, r.avg_price_usd from city c join restaurant r on c.city_id = r.city_id where c.city_name = 'taipei'
Dishes in Taipei|select f.dish_name, f.description, f.price_usd, r.rest_name, c.city_name from (city c join restaurant r on c.city_id = r.city_id) join food f on f.restaurant_id = r.rest_id where c.city_name = 'taipei'
Museums in Taiwan|select c.city_name, c.country, m.museum_name, m.type, m.description from city c join museum m on c.city_id = m.city_id where c.country = 'taiwan'
Parks in Taiwan|select c.city_name, c.country, p.park_name, p.type, p.description from city c join park p on c.city_id = p.city_id where c.country = 'taiwan'
Famous Sightseeing in Taiwan|select c.city_name, c.country, s.sight_name, s.description from city c join famous_sight s on c.city_id = s.city_id where c.country = 'taiwan'
Restaurants in Taiwan|select c.city_name, c.country, r.rest_name, r.description, r.avg_price_usd from city c join restaurant r on c.city_id = r.city_id where c.country = 'taiwan'
Dishes in Taiwan|select f.dish_name, f.description, f.price_usd, r.rest_name, c.city_name, c.country from (city c join restaurant r on c.city_id = r.city_id) join food f on f.restaurant_id = r.rest_id where c.country = 'taiwan'
Museums in Bangkok|select c.city_name, m.museum_name, m.type, m.description from city c join museum m on c.city_id = m.city_id where c.city_name = 'bangkok'
Parks in Bangkok|select c.city_name, p.park_name, p.type, p.description from city c join park p on c.city_id = p.city_id where c.city_name = 'bangkok'
Famous Sightseeing in Bangkok|select c.city_name, s.sight_name, s.description from city c join famous_sight s on c.city_id = s.city_id where c.city_name = 'bangkok'
Restaurants in Bangkok|select c.city_name, r.rest_name, r.description, r.avg_price_usd from city c join restaurant r on c.city_id = r.city_id where c.city_name = 'bangkok'
Dishes in Bangkok|select f.dish_name, f.description, f.price_usd, r.rest_name, c.city_name from (city c join restaurant r on c.city_id = r.city_id) join food f on f.restaurant_id = r.rest_id where c.city_name = 'bangkok'
Museums in Thailand|select c.city_name, c.country, m.museum_name, m.type, m.description from city c join museum m on c.city_id = m.city_id where c.country = 'thailand'
Parks in Thailand|select c.city_name, c.country, p.park_name, p.type, p.description from city c join park p on c.city_id = p.city_id where c.country = 'thailand'
Famous Sightseeing in Thailand|select c.city_name, c.country, s.sight_name, s.description from city c join famous_sight s on c.city_id = s.city_id where c.country = 'thailand'
Restaurants in Thailand|select c.city_name, c.country, r.rest_name, r.description, r.avg_price_usd from city c join restaurant r on c.city_id = r.city_id where c.country = 'thailand'
Dishes in Thailand|select f.dish_name, f.description, f.price_usd, r.rest_name, c.city_name, c.country from (city c join restaurant r on c.city_id = r.city_id) join food f on f.restaurant_id = r.rest_id where c.country = 'thailand'
Museums in Istanbul|select c.city_name, m.museum_name, m.type, m.description from city c join museum m on c.city_id = m.city_id where c.city_name = 'istanbul'
Parks in Istanbul|select c.city_name, p.park_name, p.type, p.description from city c join park p on c.city_id = p.city_id where c.city_name = 'istanbul'
Famous Sightseeing in Istanbul|select c.city_name, s.sight_name, s.description from city c join famous_sight s on c.city_id = s.city_id where c.city_name = 'istanbul'
Restaurants in Istanbul|select c.city_name, r.rest_name, r.description, r.avg_price_usd from city c join restaurant r on c.city_id = r.city_id where c.city_name = 'istanbul'
Dishes in Istanbul|select f.dish_name, f.description, f.price_usd, r.rest_name, c.city_name from (city c join restaurant r on c.city_id = r.city_id) join food f on f.restaurant_id = r.rest_id where c.city_name = 'istanbul'
Museums in Turkey|select c.city_name, c.country, m.museum_name, m.type, m.description from city c join museum m on c.city_id = m.city_id where c.country = 'turkey'
Parks in Turkey|select c.city_name, c.country, p.park_name, p.type, p.description from city c join park p on c.city_id = p.city_id where c.country = 'turkey'
Famous Sightseeing in Turkey|select c.city_name, c.country, s.sight_name, s.description from city c join famous_sight s on c.city_id = s.city_id where c.country = 'turkey'
Restaurants in Turkey|select c.city_name, c.country, r.rest_name, r.description, r.avg_price_usd from city c join restaurant r on c.city_id = r.city_id where c.country = 'turkey'
Dishes in Turkey|select f.dish_name, f.description, f.price_usd, r.rest_name, c.city_name, c.country from (city c join restaurant r on c.city_id = r.city_id) join food f on f.restaurant_id = r.rest_id where c.country = 'turkey'
Museums in Ankara|select c.city_name, m.museum_name, m.type, m.description from city c join museum m on c.city_id = m.city_id where c.city_name = 'ankara'
Parks in Ankara|select c.city_name, p.park_name, p.type, p.description from city c join park p on c.city_id = p.city_id where c.city_name = 'ankara'
Famous Sightseeing in Ankara|select c.city_name, s.sight_name, s.description from city c join famous_sight s on c.city_id = s.city_id where c.city_name = 'ankara'
Restaurants in Ankara|select c.city_name, r.rest_name, r.description, r.avg_price_usd from city c join restaurant r on c.city_id = r.city_id where c.city_name = 'ankara'
Dishes in Ankara|select f.dish_name, f.description, f.price_usd, r.rest_name, c.city_name from (city c join restaurant r on c.city_id = r.city_id) join food f on f.restaurant_id = r.rest_id where c.city_name = 'ankara'
Museums in Adana|select c.city_name, m.museum_name, m.type, m.description from city c join museum m on c.city_id = m.city_id where c.city_name = 'adana'
Parks in Adana|select c.city_name, p.park_name, p.type, p.description from city c join park p on c.city_id = p.city_id where c.city_name = 'adana'
Famous Sightseeing in Adana|select c.city_name, s.sight_name, s.description from city c join famous_sight s on c.city_id = s.city_id where c.city_name = 'adana'
Restaurants in Adana|select c.city_name, r.rest_name, r.description, r.avg_price_usd from city c join restaurant r on c.city_id = r.city_id where c.city_name = 'adana'
Dishes in Adana|select f.dish_name, f.description, f.price_usd, r.rest_name, c.city_name from (city c join restaurant r on c.city_id = r.city_id) join food f on f.restaurant_id = r.rest_id where c.city_name = 'adana'
Museums in London|select c.city_name, m.museum_name, m.type, m.description from city c join museum m on c.city_id = m.city_id where c.city_name = 'london'
Parks in London|select c.city_name, p.park_name, p.type, p.description from city c join park p on c.city_id = p.city_id where c.city_name = 'london'
Famous Sightseeing in London|select c.city_name, s.sight_name, s.description from city c join famous_sight s on c.city_id = s.city_id where c.city_name = 'london'
Restaurants in London|select c.city_name, r.rest_name, r.description, r.avg_price_usd from city c join restaurant r on c.city_id = r.city_id where c.city_name = 'london'
Dishes in London|select f.dish_name, f.description, f.price_usd, r.rest_name, c.city_name from (city c join restaurant r on c.city_id = r.city_id) join food f on f.restaurant_id = r.rest_id where c.city_name = 'london'
Museums in United Kingdom|select c.city_name, c.country, m.museum_name, m.type, m.description from city c join museum m on c.city_id = m.city_id where c.country = 'united kingdom'
Parks in United Kingdom|select c.city_name, c.country, p.park_name, p.type, p.description from city c join park p on c.city_id = p.city_id where c.country = 'united kingdom'
Famous Sightseeing in United Kingdom|select c.city_name, c.country, s.sight_name, s.description from city c join famous_sight s on c.city_id = s.city_id where c.country = 'united kingdom'
Restaurants in United Kingdom|select c.city_name, c.country, r.rest_name, r.description, r.avg_price_usd from city c join restaurant r on c.city_id = r.city_id where c.country = 'united kingdom'
Dishes in United Kingdom|select f.dish_name, f.description, f.price_usd, r.rest_name, c.city_name, c.country from (city c join restaurant r on c.city_id = r.city_id) join food f on f.restaurant_id = r.rest_id where c.country = 'united kingdom'
Museums in Birmingham|select c.city_name, m.museum_name, m.type, m.description from city c join museum m on c.city_id = m.city_id where c.city_name = 'birmingham'
Parks in Birmingham|select c.city_name, p.park_name, p.type, p.description from city c join park p on c.city_id = p.city_id where c.city_name = 'birmingham'
Famous Sightseeing in Birmingham|select c.city_name, s.sight_name, s.description from city c join famous_sight s on c.city_id = s.city_id where c.city_name = 'birmingham'
Restaurants in Birmingham|select c.city_name, r.rest_name, r.description, r.avg_price_usd from city c join restaurant r on c.city_id = r.city_id where c.city_name = 'birmingham'
Dishes in Birmingham|select f.dish_name, f.description, f.price_usd, r.rest_name, c.city_name from (city c join restaurant r on c.city_id = r.city_id) join food f on f.restaurant_id = r.rest_id where c.city_name = 'birmingham'
Museums in Washington  D.C.|select c.city_name, m.museum_name, m.type, m.description from city c join museum m on c.city_id = m.city_id where c.city_name = 'washington  d.c.'
Parks in Washington  D.C.|select c.city_name, p.park_name, p.type, p.description from city c join park p on c.city_id = p.city_id where c.city_name = 'washington  d.c.'
Famous Sightseeing in Washington  D.C.|select c.city_name, s.sight_name, s.description from city c join famous_sight s on c.city_id = s.city_id where c.city_name = 'washington  d.c.'
Restaurants in Washington  D.C.|select c.city_name, r.rest_name, r.description, r.avg_price_usd from city c join restaurant r on c.city_id = r.city_id where c.city_name = 'washington  d.c.'
Dishes in Washington  D.C.|select f.dish_name, f.description, f.price_usd, r.rest_name, c.city_name from (city c join restaurant r on c.city_id = r.city_id) join food f on f.restaurant_id = r.rest_id where c.city_name = 'washington  d.c.'
Museums in United States|select c.city_name, c.country, m.museum_name, m.type, m.description from city c join museum m on c.city_id = m.city_id where c.country = 'united states'
Parks in United States|select c.city_name, c.country, p.park_name, p.type, p.description from city c join park p on c.city_id = p.city_id where c.country = 'united states'
Famous Sightseeing in United States|select c.city_name, c.country, s.sight_name, s.description from city c join famous_sight s on c.city_id = s.city_id where c.country = 'united states'
Restaurants in United States|select c.city_name, c.country, r.rest_name, r.description, r.avg_price_usd from city c join restaurant r on c.city_id = r.city_id where c.country = 'united states'
Dishes in United States|select f.dish_name, f.description, f.price_usd, r.rest_name, c.city_name, c.country from (city c join restaurant r on c.city_id = r.city_id) join food f on f.restaurant_id = r.rest_id where c.country = 'united states'
Museums in New York City|select c.city_name, m.museum_name, m.type, m.description from city c join museum m on c.city_id = m.city_id where c.city_name = 'new york city'
Parks in New York City|select c.city_name, p.park_name, p.type, p.description from city c join park p on c.city_id = p.city_id where c.city_name = 'new york city'
Famous Sightseeing in New York City|select c.city_name, s.sight_name, s.description from city c join famous_sight s on c.city_id = s.city_id where c.city_name = 'new york city'
Restaurants in New York City|select c.city_name, r.rest_name, r.description, r.avg_price_usd from city c join restaurant r on c.city_id = r.city_id where c.city_name = 'new york city'
Dishes in New York City|select f.dish_name, f.description, f.price_usd, r.rest_name, c.city_name from (city c join restaurant r on c.city_id = r.city_id) join food f on f.restaurant_id = r.rest_id where c.city_name = 'new york city'
Museums in Chicago|select c.city_name, m.museum_name, m.type, m.description from city c join museum m on c.city_id = m.city_id where c.city_name = 'chicago'
Parks in Chicago|select c.city_name, p.park_name, p.type, p.description from city c join park p on c.city_id = p.city_id where c.city_name = 'chicago'
Famous Sightseeing in Chicago|select c.city_name, s.sight_name, s.description from city c join famous_sight s on c.city_id = s.city_id where c.city_name = 'chicago'
Restaurants in Chicago|select c.city_name, r.rest_name, r.description, r.avg_price_usd from city c join restaurant r on c.city_id = r.city_id where c.city_name = 'chicago'
Dishes in Chicago|select f.dish_name, f.description, f.price_usd, r.rest_name, c.city_name from (city c join restaurant r on c.city_id = r.city_id) join food f on f.restaurant_id = r.rest_id where c.city_name = 'chicago'
Museums in Miami|select c.city_name, m.museum_name, m.type, m.description from city c join museum m on c.city_id = m.city_id where c.city_name = 'miami'
Parks in Miami|select c.city_name, p.park_name, p.type, p.description from city c join park p on c.city_id = p.city_id where c.city_name = 'miami'
Famous Sightseeing in Miami|select c.city_name, s.sight_name, s.description from city c join famous_sight s on c.city_id = s.city_id where c.city_name = 'miami'
Restaurants in Miami|select c.city_name, r.rest_name, r.description, r.avg_price_usd from city c join restaurant r on c.city_id = r.city_id where c.city_name = 'miami'
Dishes in Miami|select f.dish_name, f.description, f.price_usd, r.rest_name, c.city_name from (city c join restaurant r on c.city_id = r.city_id) join food f on f.restaurant_id = r.rest_id where c.city_name = 'miami'
Museums in Atlanta|select c.city_name, m.museum_name, m.type, m.description from city c join museum m on c.city_id = m.city_id where c.city_name = 'atlanta'
Parks in Atlanta|select c.city_name, p.park_name, p.type, p.description from city c join park p on c.city_id = p.city_id where c.city_name = 'atlanta'
Famous Sightseeing in Atlanta|select c.city_name, s.sight_name, s.description from city c join famous_sight s on c.city_id = s.city_id where c.city_name = 'atlanta'
Restaurants in Atlanta|select c.city_name, r.rest_name, r.description, r.avg_price_usd from city c join restaurant r on c.city_id = r.city_id where c.city_name = 'atlanta'
Dishes in Atlanta|select f.dish_name, f.description, f.price_usd, r.rest_name, c.city_name from (city c join restaurant r on c.city_id = r.city_id) join food f on f.restaurant_id = r.rest_id where c.city_name = 'atlanta'
Museums in Dallas|select c.city_name, m.museum_name, m.type, m.description from city c join museum m on c.city_id = m.city_id where c.city_name = 'dallas'
Parks in Dallas|select c.city_name, p.park_name, p.type, p.description from city c join park p on c.city_id = p.city_id where c.city_name = 'dallas'
Famous Sightseeing in Dallas|select c.city_name, s.sight_name, s.description from city c join famous_sight s on c.city_id = s.city_id where c.city_name = 'dallas'
Restaurants in Dallas|select c.city_name, r.rest_name, r.description, r.avg_price_usd from city c join restaurant r on c.city_id = r.city_id where c.city_name = 'dallas'
Dishes in Dallas|select f.dish_name, f.description, f.price_usd, r.rest_name, c.city_name from (city c join restaurant r on c.city_id = r.city_id) join food f on f.restaurant_id = r.rest_id where c.city_name = 'dallas'
Museums in Philadelphia|select c.city_name, m.museum_name, m.type, m.description from city c join museum m on c.city_id = m.city_id where c.city_name = 'philadelphia'
Parks in Philadelphia|select c.city_name, p.park_name, p.type, p.description from city c join park p on c.city_id = p.city_id where c.city_name = 'philadelphia'
Famous Sightseeing in Philadelphia|select c.city_name, s.sight_name, s.description from city c join famous_sight s on c.city_id = s.city_id where c.city_name = 'philadelphia'
Restaurants in Philadelphia|select c.city_name, r.rest_name, r.description, r.avg_price_usd from city c join restaurant r on c.city_id = r.city_id where c.city_name = 'philadelphia'
Dishes in Philadelphia|select f.dish_name, f.description, f.price_usd, r.rest_name, c.city_name from (city c join restaurant r on c.city_id = r.city_id) join food f on f.restaurant_id = r.rest_id where c.city_name = 'philadelphia'
Museums in Boston|select c.city_name, m.museum_name, m.type, m.description from city c join museum m on c.city_id = m.city_id where c.city_name = 'boston'
Parks in Boston|select c.city_name, p.park_name, p.type, p.description from city c join park p on c.city_id = p.city_id where c.city_name = 'boston'
Famous Sightseeing in Boston|select c.city_name, s.sight_name, s.description from city c join famous_sight s on c.city_id = s.city_id where c.city_name = 'boston'
Restaurants in Boston|select c.city_name, r.rest_name, r.description, r.avg_price_usd from city c join restaurant r on c.city_id = r.city_id where c.city_name = 'boston'
Dishes in Boston|select f.dish_name, f.description, f.price_usd, r.rest_name, c.city_name from (city c join restaurant r on c.city_id = r.city_id) join food f on f.restaurant_id = r.rest_id where c.city_name = 'boston'
Museums in San Francisco|select c.city_name, m.museum_name, m.type, m.description from city c join museum m on c.city_id = m.city_id where c.city_name = 'san francisco'
Parks in San Francisco|select c.city_name, p.park_name, p.type, p.description from city c join park p on c.city_id = p.city_id where c.city_name = 'san francisco'
Famous Sightseeing in San Francisco|select c.city_name, s.sight_name, s.description from city c join famous_sight s on c.city_id = s.city_id where c.city_name = 'san francisco'
Restaurants in San Francisco|select c.city_name, r.rest_name, r.description, r.avg_price_usd from city c join restaurant r on c.city_id = r.city_id where c.city_name = 'san francisco'
Dishes in San Francisco|select f.dish_name, f.description, f.price_usd, r.rest_name, c.city_name from (city c join restaurant r on c.city_id = r.city_id) join food f on f.restaurant_id = r.rest_id where c.city_name = 'san francisco'
Museums in San Diego|select c.city_name, m.museum_name, m.type, m.description from city c join museum m on c.city_id = m.city_id where c.city_name = 'san diego'
Parks in San Diego|select c.city_name, p.park_name, p.type, p.description from city c join park p on c.city_id = p.city_id where c.city_name = 'san diego'
Famous Sightseeing in San Diego|select c.city_name, s.sight_name, s.description from city c join famous_sight s on c.city_id = s.city_id where c.city_name = 'san diego'
Restaurants in San Diego|select c.city_name, r.rest_name, r.description, r.avg_price_usd from city c join restaurant r on c.city_id = r.city_id where c.city_name = 'san diego'
Dishes in San Diego|select f.dish_name, f.description, f.price_usd, r.rest_name, c.city_name from (city c join restaurant r on c.city_id = r.city_id) join food f on f.restaurant_id = r.rest_id where c.city_name = 'san diego'
Museums in San Jose|select c.city_name, m.museum_name, m.type, m.description from city c join museum m on c.city_id = m.city_id where c.city_name = 'san jose'
Parks in San Jose|select c.city_name, p.park_name, p.type, p.description from city c join park p on c.city_id = p.city_id where c.city_name = 'san jose'
Famous Sightseeing in San Jose|select c.city_name, s.sight_name, s.description from city c join famous_sight s on c.city_id = s.city_id where c.city_name = 'san jose'
Restaurants in San Jose|select c.city_name, r.rest_name, r.description, r.avg_price_usd from city c join restaurant r on c.city_id = r.city_id where c.city_name = 'san jose'
Dishes in San Jose|select f.dish_name, f.description, f.price_usd, r.rest_name, c.city_name from (city c join restaurant r on c.city_id = r.city_id) join food f on f.restaurant_id = r.rest_id where c.city_name = 'san jose'
Museums in Houston|select c.city_name, m.museum_name, m.type, m.description from city c join museum m on c.city_id = m.city_id where c.city_name = 'houston'
Parks in Houston|select c.city_name, p.park_name, p.type, p.description from city c join park p on c.city_id = p.city_id where c.city_name = 'houston'
Famous Sightseeing in Houston|select c.city_name, s.sight_name, s.description from city c join famous_sight s on c.city_id = s.city_id where c.city_name = 'houston'
Restaurants in Houston|select c.city_name, r.rest_name, r.description, r.avg_price_usd from city c join restaurant r on c.city_id = r.city_id where c.city_name = 'houston'
Dishes in Houston|select f.dish_name, f.description, f.price_usd, r.rest_name, c.city_name from (city c join restaurant r on c.city_id = r.city_id) join food f on f.restaurant_id = r.rest_id where c.city_name = 'houston'
Museums in Phoenix|select c.city_name, m.museum_name, m.type, m.description from city c join museum m on c.city_id = m.city_id where c.city_name = 'phoenix'
Parks in Phoenix|select c.city_name, p.park_name, p.type, p.description from city c join park p on c.city_id = p.city_id where c.city_name = 'phoenix'
Famous Sightseeing in Phoenix|select c.city_name, s.sight_name, s.description from city c join famous_sight s on c.city_id = s.city_id where c.city_name = 'phoenix'
Restaurants in Phoenix|select c.city_name, r.rest_name, r.description, r.avg_price_usd from city c join restaurant r on c.city_id = r.city_id where c.city_name = 'phoenix'
Dishes in Phoenix|select f.dish_name, f.description, f.price_usd, r.rest_name, c.city_name from (city c join restaurant r on c.city_id = r.city_id) join food f on f.restaurant_id = r.rest_id where c.city_name = 'phoenix'
Museums in Detroit|select c.city_name, m.museum_name, m.type, m.description from city c join museum m on c.city_id = m.city_id where c.city_name = 'detroit'
Parks in Detroit|select c.city_name, p.park_name, p.type, p.description from city c join park p on c.city_id = p.city_id where c.city_name = 'detroit'
Famous Sightseeing in Detroit|select c.city_name, s.sight_name, s.description from city c join famous_sight s on c.city_id = s.city_id where c.city_name = 'detroit'
Restaurants in Detroit|select c.city_name, r.rest_name, r.description, r.avg_price_usd from city c join restaurant r on c.city_id = r.city_id where c.city_name = 'detroit'
Dishes in Detroit|select f.dish_name, f.description, f.price_usd, r.rest_name, c.city_name from (city c join restaurant r on c.city_id = r.city_id) join food f on f.restaurant_id = r.rest_id where c.city_name = 'detroit'
Museums in Denver|select c.city_name, m.museum_name, m.type, m.description from city c join museum m on c.city_id = m.city_id where c.city_name = 'denver'
Parks in Denver|select c.city_name, p.park_name, p.type, p.description from city c join park p on c.city_id = p.city_id where c.city_name = 'denver'
Famous Sightseeing in Denver|select c.city_name, s.sight_name, s.description from city c join famous_sight s on c.city_id = s.city_id where c.city_name = 'denver'
Restaurants in Denver|select c.city_name, r.rest_name, r.description, r.avg_price_usd from city c join restaurant r on c.city_id = r.city_id where c.city_name = 'denver'
Dishes in Denver|select f.dish_name, f.description, f.price_usd, r.rest_name, c.city_name from (city c join restaurant r on c.city_id = r.city_id) join food f on f.restaurant_id = r.rest_id where c.city_name = 'denver'
Museums in San Antonio|select c.city_name, m.museum_name, m.type, m.description from city c join museum m on c.city_id = m.city_id where c.city_name = 'san antonio'
Parks in San Antonio|select c.city_name, p.park_name, p.type, p.description from city c join park p on c.city_id = p.city_id where c.city_name = 'san antonio'
Famous Sightseeing in San Antonio|select c.city_name, s.sight_name, s.description from city c join famous_sight s on c.city_id = s.city_id where c.city_name = 'san antonio'
Restaurants in San Antonio|select c.city_name, r.rest_name, r.description, r.avg_price_usd from city c join restaurant r on c.city_id = r.city_id where c.city_name = 'san antonio'
Dishes in San Antonio|select f.dish_name, f.description, f.price_usd, r.rest_name, c.city_name from (city c join restaurant r on c.city_id = r.city_id) join food f on f.restaurant_id = r.rest_id where c.city_name = 'san antonio'
Museums in Seattle|select c.city_name, m.museum_name, m.type, m.description from city c join museum m on c.city_id = m.city_id where c.city_name = 'seattle'
Parks in Seattle|select c.city_name, p.park_name, p.type, p.description from city c join park p on c.city_id = p.city_id where c.city_name = 'seattle'
Famous Sightseeing in Seattle|select c.city_name, s.sight_name, s.description from city c join famous_sight s on c.city_id = s.city_id where c.city_name = 'seattle'
Restaurants in Seattle|select c.city_name, r.rest_name, r.description, r.avg_price_usd from city c join restaurant r on c.city_id = r.city_id where c.city_name = 'seattle'
Dishes in Seattle|select f.dish_name, f.description, f.price_usd, r.rest_name, c.city_name from (city c join restaurant r on c.city_id = r.city_id) join food f on f.restaurant_id = r.rest_id where c.city_name = 'seattle'
Museums in Nashville|select c.city_name, m.museum_name, m.type, m.description from city c join museum m on c.city_id = m.city_id where c.city_name = 'nashville'
Parks in Nashville|select c.city_name, p.park_name, p.type, p.description from city c join park p on c.city_id = p.city_id where c.city_name = 'nashville'
Famous Sightseeing in Nashville|select c.city_name, s.sight_name, s.description from city c join famous_sight s on c.city_id = s.city_id where c.city_name = 'nashville'
Restaurants in Nashville|select c.city_name, r.rest_name, r.description, r.avg_price_usd from city c join restaurant r on c.city_id = r.city_id where c.city_name = 'nashville'
Dishes in Nashville|select f.dish_name, f.description, f.price_usd, r.rest_name, c.city_name from (city c join restaurant r on c.city_id = r.city_id) join food f on f.restaurant_id = r.rest_id where c.city_name = 'nashville'
Museums in Tashkent|select c.city_name, m.museum_name, m.type, m.description from city c join museum m on c.city_id = m.city_id where c.city_name = 'tashkent'
Parks in Tashkent|select c.city_name, p.park_name, p.type, p.description from city c join park p on c.city_id = p.city_id where c.city_name = 'tashkent'
Famous Sightseeing in Tashkent|select c.city_name, s.sight_name, s.description from city c join famous_sight s on c.city_id = s.city_id where c.city_name = 'tashkent'
Restaurants in Tashkent|select c.city_name, r.rest_name, r.description, r.avg_price_usd from city c join restaurant r on c.city_id = r.city_id where c.city_name = 'tashkent'
Dishes in Tashkent|select f.dish_name, f.description, f.price_usd, r.rest_name, c.city_name from (city c join restaurant r on c.city_id = r.city_id) join food f on f.restaurant_id = r.rest_id where c.city_name = 'tashkent'
Museums in Uzbekistan|select c.city_name, c.country, m.museum_name, m.type, m.description from city c join museum m on c.city_id = m.city_id where c.country = 'uzbekistan'
Parks in Uzbekistan|select c.city_name, c.country, p.park_name, p.type, p.description from city c join park p on c.city_id = p.city_id where c.country = 'uzbekistan'
Famous Sightseeing in Uzbekistan|select c.city_name, c.country, s.sight_name, s.description from city c join famous_sight s on c.city_id = s.city_id where c.country = 'uzbekistan'
Restaurants in Uzbekistan|select c.city_name, c.country, r.rest_name, r.description, r.avg_price_usd from city c join restaurant r on c.city_id = r.city_id where c.country = 'uzbekistan'
Dishes in Uzbekistan|select f.dish_name, f.description, f.price_usd, r.rest_name, c.city_name, c.country from (city c join restaurant r on c.city_id = r.city_id) join food f on f.restaurant_id = r.rest_id where c.country = 'uzbekistan'
Museums in Ho Chi Minh City|select c.city_name, m.museum_name, m.type, m.description from city c join museum m on c.city_id = m.city_id where c.city_name = 'ho chi minh city'
Parks in Ho Chi Minh City|select c.city_name, p.park_name, p.type, p.description from city c join park p on c.city_id = p.city_id where c.city_name = 'ho chi minh city'
Famous Sightseeing in Ho Chi Minh City|select c.city_name, s.sight_name, s.description from city c join famous_sight s on c.city_id = s.city_id where c.city_name = 'ho chi minh city'
Restaurants in Ho Chi Minh City|select c.city_name, r.rest_name, r.description, r.avg_price_usd from city c join restaurant r on c.city_id = r.city_id where c.city_name = 'ho chi minh city'
Dishes in Ho Chi Minh City|select f.dish_name, f.description, f.price_usd, r.rest_name, c.city_name from (city c join restaurant r on c.city_id = r.city_id) join food f on f.restaurant_id = r.rest_id where c.city_name = 'ho chi minh city'
Museums in Vietnam|select c.city_name, c.country, m.museum_name, m.type, m.description from city c join museum m on c.city_id = m.city_id where c.country = 'vietnam'
Parks in Vietnam|select c.city_name, c.country, p.park_name, p.type, p.description from city c join park p on c.city_id = p.city_id where c.country = 'vietnam'
Famous Sightseeing in Vietnam|select c.city_name, c.country, s.sight_name, s.description from city c join famous_sight s on c.city_id = s.city_id where c.country = 'vietnam'
Restaurants in Vietnam|select c.city_name, c.country, r.rest_name, r.description, r.avg_price_usd from city c join restaurant r on c.city_id = r.city_id where c.country = 'vietnam'
Dishes in Vietnam|select f.dish_name, f.description, f.price_usd, r.rest_name, c.city_name, c.country from (city c join restaurant r on c.city_id = r.city_id) join food f on f.restaurant_id = r.rest_id where c.country = 'vietnam'
Museums in Hanoi|select c.city_name, m.museum_name, m.type, m.description from city c join museum m on c.city_id = m.city_id where c.city_name = 'hanoi'
Parks in Hanoi|select c.city_name, p.park_name, p.type, p.description from city c join park p on c.city_id = p.city_id where c.city_name = 'hanoi'
Famous Sightseeing in Hanoi|select c.city_name, s.sight_name, s.description from city c join famous_sight s on c.city_id = s.city_id where c.city_name = 'hanoi'
Restaurants in Hanoi|select c.city_name, r.rest_name, r.description, r.avg_price_usd from city c join restaurant r on c.city_id = r.city_id where c.city_name = 'hanoi'
Dishes in Hanoi|select f.dish_name, f.description, f.price_usd, r.rest_name, c.city_name from (city c join restaurant r on c.city_id = r.city_id) join food f on f.restaurant_id = r.rest_id where c.city_name = 'hanoi'
Museums in Athens|select c.city_name, m.museum_name, m.type, m.description from city c join museum m on c.city_id = m.city_id where c.city_name = 'athens'
Parks in Athens|select c.city_name, p.park_name, p.type, p.description from city c join park p on c.city_id = p.city_id where c.city_name = 'athens'
Famous Sightseeing in Athens|select c.city_name, s.sight_name, s.description from city c join famous_sight s on c.city_id = s.city_id where c.city_name = 'athens'
Restaurants in Athens|select c.city_name, r.rest_name, r.description, r.avg_price_usd from city c join restaurant r on c.city_id = r.city_id where c.city_name = 'athens'
Dishes in Athens|select f.dish_name, f.description, f.price_usd, r.rest_name, c.city_name from (city c join restaurant r on c.city_id = r.city_id) join food f on f.restaurant_id = r.rest_id where c.city_name = 'athens'
Museums in Greece|select c.city_name, c.country, m.museum_name, m.type, m.description from city c join museum m on c.city_id = m.city_id where c.country = 'greece'
Parks in Greece|select c.city_name, c.country, p.park_name, p.type, p.description from city c join park p on c.city_id = p.city_id where c.country = 'greece'
Famous Sightseeing in Greece|select c.city_name, c.country, s.sight_name, s.description from city c join famous_sight s on c.city_id = s.city_id where c.country = 'greece'
Restaurants in Greece|select c.city_name, c.country, r.rest_name, r.description, r.avg_price_usd from city c join restaurant r on c.city_id = r.city_id where c.country = 'greece'
Dishes in Greece|select f.dish_name, f.description, f.price_usd, r.rest_name, c.city_name, c.country from (city c join restaurant r on c.city_id = r.city_id) join food f on f.restaurant_id = r.rest_id where c.country = 'greece'
Museums in Los Angeles|select c.city_name, m.museum_name, m.type, m.description from city c join museum m on c.city_id = m.city_id where c.city_name = 'los angeles'
Parks in Los Angeles|select c.city_name, p.park_name, p.type, p.description from city c join park p on c.city_id = p.city_id where c.city_name = 'los angeles'
Famous Sightseeing in Los Angeles|select c.city_name, s.sight_name, s.description from city c join famous_sight s on c.city_id = s.city_id where c.city_name = 'los angeles'
Restaurants in Los Angeles|select c.city_name, r.rest_name, r.description, r.avg_price_usd from city c join restaurant r on c.city_id = r.city_id where c.city_name = 'los angeles'
Dishes in Los Angeles|select f.dish_name, f.description, f.price_usd, r.rest_name, c.city_name from (city c join restaurant r on c.city_id = r.city_id) join food f on f.restaurant_id = r.rest_id where c.city_name = 'los angeles'
Museums in Spokane|select c.city_name, m.museum_name, m.type, m.description from city c join museum m on c.city_id = m.city_id where c.city_name = 'spokane'
Parks in Spokane|select c.city_name, p.park_name, p.type, p.description from city c join park p on c.city_id = p.city_id where c.city_name = 'spokane'
Famous Sightseeing in Spokane|select c.city_name, s.sight_name, s.description from city c join famous_sight s on c.city_id = s.city_id where c.city_name = 'spokane'
Restaurants in Spokane|select c.city_name, r.rest_name, r.description, r.avg_price_usd from city c join restaurant r on c.city_id = r.city_id where c.city_name = 'spokane'
Dishes in Spokane|select f.dish_name, f.description, f.price_usd, r.rest_name, c.city_name from (city c join restaurant r on c.city_id = r.city_id) join food f on f.restaurant_id = r.rest_id where c.city_name = 'spokane'
cities in algeria|select city_name, country, continent from city where country = 'algeria' or continent = 'algeria';
cities in africa|select city_name, country, continent from city where country = 'africa' or continent = 'africa';
cities in angola|select city_name, country, continent from city where country = 'angola' or continent = 'angola';
cities in australia|select city_name, country, continent from city where country = 'australia' or continent = 'australia';
cities in oceania|select city_name, country, continent from city where country = 'oceania' or continent = 'oceania';
cities in austria|select city_name, country, continent from city where country = 'austria' or continent = 'austria';
cities in europe|select city_name, country, continent from city where country = 'europe' or continent = 'europe';
cities in azerbaijan|select city_name, country, continent from city where country = 'azerbaijan' or continent = 'azerbaijan';
cities in asia|select city_name, country, continent from city where country = 'asia' or continent = 'asia';
cities in bangladesh|select city_name, country, continent from city where country = 'bangladesh' or continent = 'bangladesh';
cities in brazil|select city_name, country, continent from city where country = 'brazil' or continent = 'brazil';
cities in south america|select city_name, country, continent from city where country = 'south america' or continent = 'south america';
cities in bulgaria|select city_name, country, continent from city where country = 'bulgaria' or continent = 'bulgaria';
cities in cameroon|select city_name, country, continent from city where country = 'cameroon' or continent = 'cameroon';
cities in canada|select city_name, country, continent from city where country = 'canada' or continent = 'canada';
cities in north america|select city_name, country, continent from city where country = 'north america' or continent = 'north america';
cities in china|select city_name, country, continent from city where country = 'china' or continent = 'china';
cities in colombia|select city_name, country, continent from city where country = 'colombia' or continent = 'colombia';
cities in dominican republic|select city_name, country, continent from city where country = 'dominican republic' or continent = 'dominican republic';
cities in ecuador|select city_name, country, continent from city where country = 'ecuador' or continent = 'ecuador';
cities in egypt|select city_name, country, continent from city where country = 'egypt' or continent = 'egypt';
cities in ethiopia|select city_name, country, continent from city where country = 'ethiopia' or continent = 'ethiopia';
cities in finland|select city_name, country, continent from city where country = 'finland' or continent = 'finland';
cities in france|select city_name, country, continent from city where country = 'france' or continent = 'france';
cities in georgia|select city_name, country, continent from city where country = 'georgia' or continent = 'georgia';
cities in germany|select city_name, country, continent from city where country = 'germany' or continent = 'germany';
cities in guatemala|select city_name, country, continent from city where country = 'guatemala' or continent = 'guatemala';
cities in india|select city_name, country, continent from city where country = 'india' or continent = 'india';
cities in indonesia|select city_name, country, continent from city where country = 'indonesia' or continent = 'indonesia';
cities in iran|select city_name, country, continent from city where country = 'iran' or continent = 'iran';
cities in iraq|select city_name, country, continent from city where country = 'iraq' or continent = 'iraq';
cities in italy|select city_name, country, continent from city where country = 'italy' or continent = 'italy';
cities in ivory coast|select city_name, country, continent from city where country = 'ivory coast' or continent = 'ivory coast';
cities in japan|select city_name, country, continent from city where country = 'japan' or continent = 'japan';
cities in jordan|select city_name, country, continent from city where country = 'jordan' or continent = 'jordan';
cities in kenya|select city_name, country, continent from city where country = 'kenya' or continent = 'kenya';
cities in kuwait|select city_name, country, continent from city where country = 'kuwait' or continent = 'kuwait';
cities in mexico|select city_name, country, continent from city where country = 'mexico' or continent = 'mexico';
cities in morocco|select city_name, country, continent from city where country = 'morocco' or continent = 'morocco';
cities in nepal|select city_name, country, continent from city where country = 'nepal' or continent = 'nepal';
cities in netherlands|select city_name, country, continent from city where country = 'netherlands' or continent = 'netherlands';
cities in nigeria|select city_name, country, continent from city where country = 'nigeria' or continent = 'nigeria';
cities in north korea|select city_name, country, continent from city where country = 'north korea' or continent = 'north korea';
cities in pakistan|select city_name, country, continent from city where country = 'pakistan' or continent = 'pakistan';
cities in paraguay|select city_name, country, continent from city where country = 'paraguay' or continent = 'paraguay';
cities in peru|select city_name, country, continent from city where country = 'peru' or continent = 'peru';
cities in philippines|select city_name, country, continent from city where country = 'philippines' or continent = 'philippines';
cities in portugal|select city_name, country, continent from city where country = 'portugal' or continent = 'portugal';
cities in puerto rico|select city_name, country, continent from city where country = 'puerto rico' or continent = 'puerto rico';
cities in russia|select city_name, country, continent from city where country = 'russia' or continent = 'russia';
cities in saudi arabia|select city_name, country, continent from city where country = 'saudi arabia' or continent = 'saudi arabia';
cities in singapore|select city_name, country, continent from city where country = 'singapore' or continent = 'singapore';
cities in south africa|select city_name, country, continent from city where country = 'south africa' or continent = 'south africa';
cities in south korea|select city_name, country, continent from city where country = 'south korea' or continent = 'south korea';
cities in spain|select city_name, country, continent from city where country = 'spain' or continent = 'spain';
cities in sudan|select city_name, country, continent from city where country = 'sudan' or continent = 'sudan';
cities in syria|select city_name, country, continent from city where country = 'syria' or continent = 'syria';
cities in taiwan|select city_name, country, continent from city where country = 'taiwan' or continent = 'taiwan';
cities in thailand|select city_name, country, continent from city where country = 'thailand' or continent = 'thailand';
cities in turkey|select city_name, country, continent from city where country = 'turkey' or continent = 'turkey';
cities in united kingdom|select city_name, country, continent from city where country = 'united kingdom' or continent = 'united kingdom';
cities in united states|select city_name, country, continent from city where country = 'united states' or continent = 'united states';
cities in uzbekistan|select city_name, country, continent from city where country = 'uzbekistan' or continent = 'uzbekistan';
cities in vietnam|select city_name, country, continent from city where country = 'vietnam' or continent = 'vietnam';
cities in greece|select city_name, country, continent from city where country = 'greece' or continent = 'greece';
